
Term A,Term B,conjunction,A~B,B~A,disjunction,conj/disj
"Amygdala",("Nucleus cuneatus" OR "cuneate nucleus"),11,23346,681,24027,0.00045781828776
Ambiguus,"Posterior cingulate",1,1215,1901,3116,0.000320924261874
"Amygdala",Striatum,2539,20818,56401,77219,0.0328805086831
"Amygdala",("Ventral posterolateral" AND (nuclei OR nucleus)),6,23351,142,23493,0.000255395224109
"Angular gyrus",(Dorsomedial AND hypothal*),0,502,2139,2641,0.0
(Intralaminar AND (nuclei OR nucleus)),Perirhinal,19,1081,1181,2262,0.00839964633068
Cerebellum,Pons,4504,60896,21080,81976,0.05494291012
"Anterior cingulate",("Centromedian" AND (nuclei OR nucleus)),2,5800,214,6014,0.000332557366146
(Intralaminar AND (nuclei OR nucleus)),Subthalam*,69,1031,4060,5091,0.0135533294048
"Lateral geniculate","Primary auditory",5,5175,1864,7039,0.000710328171615
"Dentate gyrus",("Heschl's gyrus" OR "Transverse temporal"),14,11429,1134,12563,0.00111438350712
Fusiform,(Periventricular AND (nuclei OR nucleus)),18,5437,2477,7914,0.00227445034117
("Heschl's gyrus" OR "Transverse temporal"),"Paracentral lobule",1,1147,64,1211,0.000825763831544
("Heschl's gyrus" OR "Transverse temporal"),"Posterior parahippocampal gyrus",1,1147,40,1187,0.000842459983151
("Heschl's gyrus" OR "Transverse temporal"),Subgranular,0,1148,632,1780,0.0
Cingulum,"Wernicke's area",1,684,250,934,0.00107066381156
Claustrum,"Lateral geniculate",149,82592,5031,87623,0.00170046677242
("Gustatory cortex" OR "gustatory area"),("Red nucleus"),0,153,2376,2529,0.0
Cingulum,Thalamus,72,613,42810,43423,0.00165810745457
"Dentate gyrus","Nucleus basalis",30,11413,1817,13230,0.00226757369615
"Indusium griseum","Paracentral lobule",0,77,65,142,0.0
Hypothalam*,"Piriform cortex",327,107222,1416,108638,0.00300999650214
(Inferior AND collicul*),Pons,595,3688,24989,28677,0.0207483349025
Fusiform,"Ventromedial prefrontal",0,5455,3,5458,0.0
("Inferior olive" OR "Inferior olivary"),("Posterior nucleus" AND hypothalamus),2,2378,65,2443,0.000818665575113
"Interstitial nucleus",("Ventral posterior" AND (nuclei OR nucleus)),2,512,354,866,0.00230946882217
"Lingual gyrus",(Raphe AND (nuclei OR nucleus)),0,254,8321,8575,0.0
"Interstitial nucleus",("Locus coeruleus" OR "locus ceruleus"),34,480,7605,8085,0.00420531849103
(Inferior AND collicul*),Striatum,163,4120,58777,62897,0.00259153854715
("Nucleus gracilis" OR "gracile nucleus"),"Primary motor",1,373,3204,3577,0.000279563880347
(Inferior AND collicul*),"Superior temporal",21,4262,4086,8348,0.00251557259224
"Middle frontal",("Ventral anterior" AND (nuclei OR nucleus)),0,1028,237,1265,0.0
"Medial frontal",(Raphe AND (nuclei OR nucleus)),13,1582,8308,9890,0.00131445904954
"Medial frontal",Precuneus,97,1498,1123,2621,0.0370087752766
"Paracentral lobule","Primary sensory",1,64,3009,3073,0.000325414904003
"Posterior cingulate","Visual cortex",73,1829,22807,24636,0.00296314336743
Pons,"Stria terminalis",157,25427,2573,28000,0.00560714285714
Pons,Subgranular,1,25583,631,26214,3.81475547417e-05
"Paracentral lobule",("Posterior nucleus" AND hypothalamus),0,65,67,132,0.0
Perirhinal,"Superior frontal",0,1200,1091,2291,0.0
(Periventricular AND (nuclei OR nucleus)),Subthalam*,18,2477,4111,6588,0.00273224043716
Striatum,"Substantia nigra",8951,49989,10436,60425,0.148134050476
(Superior AND collicul*),("Superior olive" OR "superior olivary"),442,9642,815,10457,0.0422683369991
("Superior olive" OR "superior olivary"),"Wernicke's area",0,1257,251,1508,0.0
Putamen,Subthalam*,288,10461,3841,14302,0.0201370437701
Subthalam*,"Superior temporal",10,4119,4097,8216,0.00121713729309
Precuneus,("Ventral posterior" AND (nuclei OR nucleus)),0,1220,356,1576,0.0
"Amygdala",Hippocamp*,8571,14786,95523,110309,0.0776999156914
"Angular gyrus",Striatum,7,495,58933,59428,0.000117789594131
"Calcarine fissure",Caudate,1,102,18800,18902,5.29044545551e-05
"Angular gyrus","Wernicke's area",15,487,236,723,0.0207468879668
"Angular gyrus","Postcentral gyrus",13,489,518,1007,0.012909632572
"Angular gyrus",(Raphe AND (nuclei OR nucleus)),1,501,8320,8821,0.000113365831538
(Dorsomedial AND hypothal*),Fusiform,9,2130,5446,7576,0.00118796198522
Fusiform,"Nucleus accumbens",9,5446,12536,17982,0.000500500500501
"Dorsolateral prefrontal",Subiculum,270,2734,97971,100705,0.00268109825729
"Broca's area",Putamen,17,677,10732,11409,0.00149005171356
Caudate,"Medial geniculate",73,18728,1176,19904,0.00366760450161
("Centromedian" AND (nuclei OR nucleus)),"Diagonal band of Broca",0,216,895,1111,0.0
("Centromedian" AND (nuclei OR nucleus)),"Inferior frontal",0,216,2812,3028,0.0
Caudate,("Nucleus cuneatus" OR "cuneate nucleus"),13,18788,679,19467,0.000667796784302
Hypothalam*,Temporoparietal,5,107544,1455,108999,4.58719804769e-05
"Dentate gyrus",Perirhinal,118,11325,1082,12407,0.00951076005481
"Inferior parietal lobule","Postcentral gyrus",46,750,485,1235,0.0372469635628
("Inferior olive" OR "Inferior olivary"),("Nucleus gracilis" OR "gracile nucleus"),27,2353,347,2700,0.01
"Lingual gyrus",periaqueductal,1,253,4575,4828,0.000207125103563
("Mammillary body" OR "Mammillary bodies),Premotor,3,1366,4726,6092,0.000492449113592
("Locus coeruleus" OR "locus ceruleus"),"Nucleus accumbens",309,7330,12236,19566,0.0157927016253
"Nucleus basalis","Primary motor",7,1840,3198,5038,0.00138944025407
"Nucleus basalis",Temporoparietal,4,1843,1456,3299,0.00121248863292
("Mammillary body" OR "Mammillary bodies),Thalamus,409,960,42473,43433,0.00941680289181
"Nucleus basalis",("Ventral anterior" AND (nuclei OR nucleus)),0,1847,237,2084,0.0
("Nucleus cuneatus" OR "cuneate nucleus"),("Superior olive" OR "superior olivary"),9,683,1248,1931,0.00466079751424
"Inferior frontal",periaqueductal,8,2804,4568,7372,0.00108518719479
"Posterior cingulate","Ventromedial prefrontal",0,1902,3,1905,0.0
Premotor,"Primary sensory",55,4674,2955,7629,0.00720933280902
Pineal,"Posterior parietal",1,14402,2153,16555,6.04047115675e-05
(Superior AND collicul*),Thalamus,2196,7888,40686,48574,0.0452093712686
("Ventral anterior" AND (nuclei OR nucleus)),("Ventral posteromedial" AND (nuclei OR nucleus)),1,236,111,347,0.0028818443804
Subgranular,Suprachiasmatic,0,632,6026,6658,0.0
Prefrontal,("Ventral posterolateral" AND (nuclei OR nucleus)),2,24099,146,24245,8.24912353062e-05
Subthalam*,("Ventral posteromedial" AND (nuclei OR nucleus)),3,4126,109,4235,0.000708382526564
Pulvinar,(Septal AND (nuclei OR nucleus)),2,1131,4658,5789,0.00034548281223
(Intralaminar AND (nuclei OR nucleus)),("Ventral posterior" AND (nuclei OR nucleus)),32,1068,324,1392,0.0229885057471
"Lateral geniculate","Pontine nuclei",35,5145,763,5908,0.00592417061611
"Calcarine fissure","Lateral geniculate",9,94,5171,5265,0.0017094017094
Cingulate,"Dentate gyrus",230,10874,11213,22087,0.010413365328
"Diagonal band of Broca","Globus pallidus",57,838,8049,8887,0.00641386294588
(Dorsomedial AND hypothal*),Hypothalam*,2139,0,105410,105410,0.0202921923916
"Diagonal band of Broca","Thalamic reticular",0,895,600,1495,0.0
"Dorsolateral prefrontal",Infralimbic,3,3001,493,3494,0.000858614768174
"Dorsolateral prefrontal","Supplementary motor",178,2826,2183,5009,0.0355360351368
Ambiguus,("Ventral anterior" AND (nuclei OR nucleus)),1,1215,236,1451,0.000689179875948
"Calcarine fissure",Prefrontal,1,102,24100,24202,4.13188992645e-05
"Basal forbrain",Striatum,0,1,58940,58941,0.0
Caudate,"Calcarine fissure",1,18800,102,18902,5.29044545551e-05
Cingulum,"Diagonal band of Broca",5,680,890,1570,0.0031847133758
("Centromedian" AND (nuclei OR nucleus)),("Heschl's gyrus" OR "Transverse temporal"),0,216,1148,1364,0.0
Cingulum,"Primary sensory",0,685,3010,3695,0.0
("Gustatory cortex" OR "gustatory area"),Thalamus,29,124,42853,42977,0.000674779533239
"Indusium griseum","Stria terminalis",4,73,2726,2799,0.00142908181493
(Cochlear AND (nuclei OR nucleus)),"Inferior temporal",0,5307,1711,7018,0.0
Entorhinal,Subiculum,4048,1499,94193,95692,0.0423023868244
(Cochlear AND (nuclei OR nucleus)),Precuneus,0,5307,1220,6527,0.0
Entorhinal,("Ventral posterior" AND (nuclei OR nucleus)),4,5543,352,5895,0.000678541136556
Hypothalam*,"Zona incerta",540,107009,434,107443,0.00502592072075
"Indusium griseum","Postcentral gyrus",0,77,531,608,0.0
"Dentate gyrus",("Ventral posterior" AND (nuclei OR nucleus)),6,11437,350,11787,0.000509035377959
"Inferior parietal lobule","Primary motor",29,767,3176,3943,0.00735480598529
"Inferior frontal","Ventromedial prefrontal",0,2812,3,2815,0.0
Hippocamp*,Pulvinar,49,104045,1084,105129,0.00046609403685
Hippocamp*,Pons,1982,102112,23602,125714,0.0157659449226
"Lingual gyrus","Zona incerta",0,254,974,1228,0.0
("Locus coeruleus" OR "locus ceruleus"),"Medial geniculate",35,7604,1214,8818,0.00396915400318
("Mammillary body" OR "Mammillary bodies),"Postcentral gyrus",3,3,529,532,0.00563909774436
"Medial frontal","Piriform cortex",3,1592,1740,3332,0.000900360144058
("Medial dorsal" AND nucl*),(Septal AND (nuclei OR nucleus)),2,111,4658,4769,0.000419375131055
"Medial geniculate",Subiculum,129,1120,98112,99232,0.00129998387617
("Nucleus gracilis" OR "gracile nucleus"),"Primary sensory",21,353,2989,3342,0.00628366247756
("Nucleus gracilis" OR "gracile nucleus"),Perirhinal,0,374,1200,1574,0.0
Parahippocamp*,Subthalam*,6,2653,4123,6776,0.000885478158205
periaqueductal,Subthalam*,50,4526,4079,8605,0.00581057524695
"Middle temporal","Piriform cortex",2,1635,1741,3376,0.000592417061611
"Nucleus accumbens",Perirhinal,41,12504,1159,13663,0.00300080509405
"Nucleus accumbens",Pons,190,12355,25394,37749,0.0050332459138
"Postcentral gyrus",("Posterior nucleus" AND hypothalamus),0,531,67,598,0.0
"Medial frontal",Suprachiasmatic,1,1594,6025,7619,0.000131250820318
Pons,("Red nucleus"),296,25288,2080,27368,0.0108155510085
"Posterior cingulate",(Septal AND (nuclei OR nucleus)),5,1897,4655,6552,0.000763125763126
Premotor,"Thalamic reticular",3,4726,597,5323,0.000563591959421
"Posterior parietal",("Straight gyrus" OR "gyrus rectus"),0,2154,130,2284,0.0
(Superior AND collicul*),Temporoparietal,1,10083,1459,11542,8.66400970369e-05
"Posterior parahippocampal gyrus",("Ventral anterior" AND (nuclei OR nucleus)),0,41,237,278,0.0
"Supplementary motor","Ventromedial prefrontal",0,2361,3,2364,0.0
Putamen,("Ventral anterior" AND (nuclei OR nucleus)),25,10724,212,10936,0.0022860277981
"Basal forbrain","Anterior cingulate",0,1,5802,5803,0.0
Cerebellum,"Ventromedial prefrontal",0,65400,3,65403,0.0
"Dorsolateral prefrontal","Primary auditory",6,2998,1863,4861,0.00123431392718
Ambiguus,Subthalam*,4,1212,4125,5337,0.000749484729249
Ambiguus,"Superior temporal",1,1215,4106,5321,0.00018793459876
"Basal forbrain",("Superior olive" OR "superior olivary"),0,1,1257,1258,0.0
"Broca's area","Primary sensory",3,691,3007,3698,0.000811249323959
"Amygdala","Dentate gyrus",768,22589,10675,33264,0.023088023088
"Basal forbrain",(Superior AND collicul*),0,1,10084,10085,0.0
Caudate,Operculum,18,18783,908,19691,0.000914123203494
Caudate,("Superior olive" OR "superior olivary"),18,18783,1239,20022,0.000899011087803
"Dentate gyrus",Temporoparietal,0,11443,1460,12903,0.0
"Globus pallidus","Interstitial nucleus",12,8094,502,8596,0.00139599813867
("Inferior olive" OR "Inferior olivary"),"Paracentral lobule",0,2380,65,2445,0.0
Hippocamp*,"Middle temporal",172,103922,1465,105387,0.00163207985805
"Medial frontal",Pineal,1,1594,14402,15996,6.25156289072e-05
"Medial frontal",(Periventricular AND (nuclei OR nucleus)),2,1593,2493,4086,0.000489476260401
"Medial geniculate",Subgranular,0,1249,632,1881,0.0
"Medial frontal","Wernicke's area",1,1594,250,1844,0.000542299349241
"Pontine nuclei",("Superior olive" OR "superior olivary"),22,776,1235,2011,0.0109398309299
"Middle frontal","Visual extrastriate",8,1020,1526,2546,0.00314218381775
"Paracentral lobule",(Superior AND collicul*),0,65,10084,10149,0.0
"Paracentral lobule","Superior frontal",9,56,1082,1138,0.0079086115993
(Periventricular AND (nuclei OR nucleus)),("Ventral anterior" AND (nuclei OR nucleus)),3,2492,234,2726,0.001100513573
("Straight gyrus" OR "gyrus rectus"),("Ventral posterolateral" AND (nuclei OR nucleus)),0,130,148,278,0.0
Precuneus,"Posterior parietal",62,1158,2092,3250,0.0190769230769
"Piriform cortex",Pons,43,1700,25541,27241,0.00157850299181
"Superior temporal",("Ventral anterior" AND (nuclei OR nucleus)),2,4105,235,4340,0.000460829493088
Precuneus,"Superior temporal",161,1059,3946,5005,0.0321678321678
"Visual cortex","Ventromedial prefrontal",0,22880,3,22883,0.0
Suprachiasmatic,"Visual cortex",39,5987,22841,28828,0.00135285139448
Precuneus,"Wernicke's area",6,1214,245,1459,0.00411240575737
Temporoparietal,("Ventral posterior" AND (nuclei OR nucleus)),0,1460,356,1816,0.0
"Amygdala",("Posterior nucleus" AND hypothalamus),13,23344,54,23398,0.000555603042995
"Amygdala","Olfactory bulb",916,22441,10295,32736,0.027981427175
"Anterior cingulate",Hippocamp*,804,4998,103290,108288,0.00742464539007
Cingulate,"Interstitial nucleus",9,11095,505,11600,0.000775862068966
(Intralaminar AND (nuclei OR nucleus)),Pons,69,1031,25515,26546,0.00259926165901
Cerebellum,Fusiform,279,65121,5176,70297,0.00396887491643
"Diagonal band of Broca",("Red nucleus"),3,892,2373,3265,0.000918836140888
"Basal forbrain","Paracentral lobule",0,1,65,66,0.0
"Basal forbrain","Primary motor",0,1,3205,3206,0.0
("Gustatory cortex" OR "gustatory area"),"Inferior frontal",1,152,2811,2963,0.000337495781303
("Heschl's gyrus" OR "Transverse temporal"),("Locus coeruleus" OR "locus ceruleus"),1,1147,7638,8785,0.000113830392715
Entorhinal,"Olfactory bulb",263,5284,10948,16232,0.0162025628388
("Heschl's gyrus" OR "Transverse temporal"),Operculum,10,1138,916,2054,0.00486854917235
Caudate,"Ventromedial prefrontal",1,18800,2,18802,5.31858312945e-05
Claustrum,("Ventral posterior" AND (nuclei OR nucleus)),34,82707,322,83029,0.000409495477484
"Dentate gyrus",(Septal AND (nuclei OR nucleus)),217,11226,4443,15669,0.0138490012126
"Dentate gyrus",periaqueductal,53,11390,4523,15913,0.00333061019292
"Indusium griseum",(Raphe AND (nuclei OR nucleus)),7,70,8314,8384,0.000834923664122
"Dentate gyrus","Middle temporal",2,11441,1635,13076,0.00015295197308
"Inferior temporal",Pineal,1,1710,14402,16112,6.20655412115e-05
"Inferior temporal","Stria terminalis",1,1710,2729,4439,0.000225275963055
("Inferior olive" OR "Inferior olivary"),Striatum,89,2291,58851,61142,0.00145562788263
"Lingual gyrus","Nucleus accumbens",1,253,12544,12797,7.81433148394e-05
"Interstitial nucleus",Parahippocamp*,1,513,2658,3171,0.000315357931252
"Lingual gyrus","Middle temporal",36,218,1601,1819,0.0197910940077
"Inferior temporal",("Medial dorsal" AND nucl*),3,1708,110,1818,0.0016501650165
"Interstitial nucleus",("Mammillary body" OR "Mammillary bodies),4,510,4,514,0.00778210116732
("Mammillary body" OR "Mammillary bodies),"Zona incerta",27,27,951,978,0.0276073619632
Infralimbic,Prefrontal,304,192,23797,23989,0.0126724748843
"Olfactory bulb",("Nucleus gracilis" OR "gracile nucleus"),5,11206,369,11575,0.000431965442765
Infralimbic,"Lingual gyrus",0,496,254,750,0.0
Pons,Subthalam*,129,25455,4000,29455,0.0043795620438
Pineal,(Periventricular AND (nuclei OR nucleus)),34,14369,2461,16830,0.0020202020202
("Straight gyrus" OR "gyrus rectus"),"Superior frontal",10,120,1081,1201,0.00832639467111
Pulvinar,"Ventromedial prefrontal",0,1133,3,1136,0.0
Ambiguus,Fusiform,2,1214,5453,6667,0.00029998500075
"Anterior cingulate","Posterior parietal",155,5647,1999,7646,0.0202720376668
Cingulate,("Nucleus cuneatus" OR "cuneate nucleus"),4,11100,688,11788,0.000339328130302
"Angular gyrus",("Locus coeruleus" OR "locus ceruleus"),0,502,7639,8141,0.0
Cerebellum,"Pontine nuclei",392,65008,406,65414,0.00599260097227
"Diagonal band of Broca",("Ventral posterior" AND (nuclei OR nucleus)),0,895,356,1251,0.0
"Calcarine fissure",Premotor,0,103,4729,4832,0.0
Cingulum,Hippocamp*,161,524,103933,104457,0.00154130407728
Claustrum,"Piriform cortex",327,82414,1416,83830,0.00390075152094
Cingulum,"Paracentral lobule",1,684,64,748,0.00133689839572
Hypothalam*,"Ventral tegmentum",79,107470,206,107676,0.000733682529069
Hypothalam*,"Ventromedial prefrontal",0,107549,3,107552,0.0
(Inferior AND collicul*),"Primary auditory",121,4162,1748,5910,0.0204737732657
("Inferior olive" OR "Inferior olivary"),(Raphe AND (nuclei OR nucleus)),175,2205,8146,10351,0.0169065790745
Hippocamp*,("Locus coeruleus" OR "locus ceruleus"),1203,102891,6436,109327,0.0110036861891
Hippocamp*,"Thalamic reticular",39,104055,561,104616,0.000372791924753
"Interstitial nucleus",("Straight gyrus" OR "gyrus rectus"),0,514,130,644,0.0
(Intralaminar AND (nuclei OR nucleus)),Orbitofrontal,11,1089,2985,4074,0.0027000490918
("Nucleus gracilis" OR "gracile nucleus"),Temporoparietal,0,374,1460,1834,0.0
"Olfactory bulb",Pineal,117,11094,14286,25380,0.00460992907801
Insula*,"Medial geniculate",24,17149,1225,18374,0.00130619353434
(Medulla OR "medulla oblongata"),Subgranular,2,50820,630,51450,3.88726919339e-05
"Pontine nuclei",Subiculum,112,686,98129,98815,0.00113343115924
"Nucleus accumbens","Middle temporal",7,12538,1630,14168,0.000494071146245
Operculum,Prefrontal,102,824,23999,24823,0.00410909237401
Orbitofrontal,Pineal,1,2995,14402,17397,5.74811749152e-05
Pons,Precuneus,16,25568,1204,26772,0.000597639324668
"Posterior cingulate",(Superior AND collicul*),11,1891,10073,11964,0.000919424941491
Premotor,("Ventral posterolateral" AND (nuclei OR nucleus)),2,4727,146,4873,0.000410424789657
(Periventricular AND (nuclei OR nucleus)),Premotor,6,2489,4723,7212,0.000831946755408
(Septal AND (nuclei OR nucleus)),"Visual cortex",32,4628,22848,27476,0.00116465278789
"Posterior parahippocampal gyrus","Thalamic reticular",0,41,600,641,0.0
Suprachiasmatic,"Wernicke's area",0,6026,251,6277,0.0
Putamen,Subgranular,3,10746,629,11375,0.000263736263736
"Substantia nigra",Temporoparietal,0,19387,1460,20847,0.0
"Angular gyrus",(Periventricular AND (nuclei OR nucleus)),0,502,2495,2997,0.0
"Lateral geniculate","Supplementary motor",1,5179,2360,7539,0.000132643586683
(Dorsomedial AND hypothal*),(Periventricular AND (nuclei OR nucleus)),344,1795,2151,3946,0.0871768879878
Cerebellum,Hypothalam*,3946,61454,103603,165057,0.0239068927704
(Dorsomedial AND hypothal*),"Lateral geniculate",30,2109,5150,7259,0.00413280066125
"Globus pallidus",Putamen,1639,6467,9110,15577,0.105219233485
"Basal forbrain",Suprachiasmatic,0,1,6026,6027,0.0
"Broca's area",(Periventricular AND (nuclei OR nucleus)),2,692,2493,3185,0.000627943485086
("Heschl's gyrus" OR "Transverse temporal"),("Nucleus gracilis" OR "gracile nucleus"),0,1148,374,1522,0.0
("Gustatory cortex" OR "gustatory area"),"Zona incerta",2,151,972,1123,0.00178094390027
"Dentate gyrus",(Periventricular AND (nuclei OR nucleus)),40,11403,2455,13858,0.00288641939674
"Indusium griseum","Inferior temporal",0,77,1711,1788,0.0
"Inferior temporal","Piriform cortex",1,1710,1742,3452,0.000289687137891
("Inferior olive" OR "Inferior olivary"),Pons,345,2035,25239,27274,0.0126494096942
("Inferior olive" OR "Inferior olivary"),"Interstitial nucleus",46,2334,468,2802,0.0164168451106
"Inferior parietal lobule",Putamen,34,762,10715,11477,0.0029624466324
"Inferior frontal","Supplementary motor",138,2674,2223,4897,0.0281805186849
"Inferior temporal",Subthalam*,3,1708,4126,5834,0.000514226945492
"Inferior temporal",("Ventral posterior" AND (nuclei OR nucleus)),0,1711,356,2067,0.0
"Inferior temporal","Thalamic reticular",0,1711,600,2311,0.0
"Lingual gyrus","Superior temporal",44,210,4063,4273,0.0102972150714
("Medial dorsal" AND nucl*),("Ventral posteromedial" AND (nuclei OR nucleus)),0,113,112,225,0.0
"Medial frontal","Pontine nuclei",1,1594,797,2391,0.000418235048097
("Nucleus gracilis" OR "gracile nucleus"),"Visual extrastriate",0,374,1534,1908,0.0
("Nucleus gracilis" OR "gracile nucleus"),("Ventral posterolateral" AND (nuclei OR nucleus)),8,366,140,506,0.0158102766798
Parahippocamp*,"Superior temporal",259,2400,3848,6248,0.0414532650448
"Middle frontal","Stria terminalis",0,1028,2730,3758,0.0
(Medulla OR "medulla oblongata"),Premotor,280,50542,4449,54991,0.0050917422851
(Medulla OR "medulla oblongata"),Perirhinal,8,50814,1192,52006,0.000153828404415
Operculum,("Posterior nucleus" AND hypothalamus),0,926,67,993,0.0
"Postcentral gyrus",("Superior olive" OR "superior olivary"),0,531,1257,1788,0.0
("Locus coeruleus" OR "locus ceruleus"),Temporoparietal,2,7637,1458,9095,0.00021990104453
"Paracentral lobule","Substantia nigra",0,65,19387,19452,0.0
"Posterior cingulate",Thalamus,324,1578,42558,44136,0.00734094616639
Pons,"Thalamic reticular",17,25567,583,26150,0.000650095602294
Pineal,("Straight gyrus" OR "gyrus rectus"),0,14403,130,14533,0.0
(Septal AND (nuclei OR nucleus)),("Ventral posterior" AND (nuclei OR nucleus)),10,4650,346,4996,0.00200160128102
Subgranular,(Superior AND collicul*),1,631,10083,10714,9.33358222886e-05
Subgranular,("Ventral posterior" AND (nuclei OR nucleus)),0,632,356,988,0.0
"Anterior cingulate","Interstitial nucleus",1,5801,513,6314,0.000158378207159
Cerebellum,"Middle temporal",122,65278,1515,66793,0.00182653870915
"Anterior cingulate",(Medulla OR "medulla oblongata"),45,5757,50777,56534,0.000795981179467
Cerebellum,(Septal AND (nuclei OR nucleus)),201,65199,4459,69658,0.00288552642913
Cingulate,Operculum,127,10977,799,11776,0.0107846467391
Cingulate,Entorhinal,412,10692,5135,15827,0.0260314652177
Cerebellum,"Diagonal band of Broca",28,65372,867,66239,0.000422711695527
(Dorsomedial AND hypothal*),"Postcentral gyrus",0,2139,531,2670,0.0
"Diagonal band of Broca","Primary sensory",0,895,3010,3905,0.0
"Basal forbrain","Postcentral gyrus",0,1,531,532,0.0
"Basal forbrain",("Ventral anterior" AND (nuclei OR nucleus)),0,1,237,238,0.0
("Heschl's gyrus" OR "Transverse temporal"),"Inferior temporal",16,1132,1695,2827,0.00565970993987
("Heschl's gyrus" OR "Transverse temporal"),"Medial geniculate",8,1140,1241,2381,0.00335993280134
("Heschl's gyrus" OR "Transverse temporal"),"Substantia nigra",3,1145,19384,20529,0.000146134736227
Cingulum,"Dentate gyrus",15,670,11428,12098,0.0012398743594
Cingulum,Insula*,34,651,17139,17790,0.00191118605958
Cingulum,"Primary motor",2,683,3203,3886,0.000514668039115
Claustrum,("Medial dorsal" AND nucl*),30,82711,83,82794,0.000362345097471
"Dentate gyrus",("Medial dorsal" AND nucl*),3,11440,110,11550,0.00025974025974
(Inferior AND collicul*),("Mammillary body" OR "Mammillary bodies),34,4249,1335,5584,0.0060888252149
"Indusium griseum","Supplementary motor",0,77,2361,2438,0.0
"Inferior temporal","Interstitial nucleus",0,1711,514,2225,0.0
Hippocamp*,("Red nucleus"),199,103895,2177,106072,0.00187608416924
"Inferior temporal",(Intralaminar AND (nuclei OR nucleus)),2,1709,1098,2807,0.000712504453153
("Medial dorsal" AND nucl*),"Piriform cortex",3,110,1740,1850,0.00162162162162
"Interstitial nucleus","Lateral geniculate",16,498,5164,5662,0.00282585658778
("Nucleus cuneatus" OR "cuneate nucleus"),"Visual extrastriate",0,692,1534,2226,0.0
Parahippocamp*,"Primary motor",15,2644,3190,5834,0.00257113472746
"Medial geniculate","Visual cortex",38,1211,22842,24053,0.00157984451004
periaqueductal,Prefrontal,181,4395,23920,28315,0.00639237153452
Perirhinal,Precuneus,3,1197,1217,2414,0.00124275062138
(Medulla OR "medulla oblongata"),Pineal,209,50613,14194,64807,0.00322496026664
Perirhinal,"Posterior parahippocampal gyrus",3,1197,38,1235,0.00242914979757
(Medulla OR "medulla oblongata"),"Supplementary motor",14,50808,2347,53155,0.000263380679146
Perirhinal,("Ventral posteromedial" AND (nuclei OR nucleus)),2,1198,110,1308,0.00152905198777
Premotor,Pulvinar,20,4709,1113,5822,0.00343524562006
Pineal,Putamen,43,14360,10706,25066,0.00171547115615
"Primary motor",Subiculum,113,3092,98128,101220,0.00111638016202
(Superior AND collicul*),"Zona incerta",170,9914,804,10718,0.0158611681284
(Superior AND collicul*),"Ventral tegmentum",9,10075,276,10351,0.000869481209545
Prefrontal,Subiculum,3698,20403,94543,114946,0.0321716284168
Pulvinar,("Superior olive" OR "superior olivary"),0,1133,1257,2390,0.0
Ambiguus,"Inferior temporal",0,1216,1711,2927,0.0
"Anterior cingulate","Indusium griseum",1,5801,76,5877,0.000170154840905
Ambiguus,Subgranular,0,1216,632,1848,0.0
"Basal forbrain",("Gustatory cortex" OR "gustatory area"),0,1,153,154,0.0
Cingulate,"Lateral geniculate",41,11063,5139,16202,0.00253055178373
("Centromedian" AND (nuclei OR nucleus)),Pons,12,204,25572,25776,0.000465549348231
"Angular gyrus","Ventral tegmentum",0,502,285,787,0.0
(Cochlear AND (nuclei OR nucleus)),("Straight gyrus" OR "gyrus rectus"),0,5307,130,5437,0.0
Fusiform,("Locus coeruleus" OR "locus ceruleus"),29,5426,7610,13036,0.0022246087757
"Dorsolateral prefrontal",Pulvinar,15,2989,1118,4107,0.0036523009496
"Dorsolateral prefrontal","Lingual gyrus",19,2985,235,3220,0.00590062111801
Cerebellum,("Locus coeruleus" OR "locus ceruleus"),635,64765,7004,71769,0.00884783123633
("Centromedian" AND (nuclei OR nucleus)),"Nucleus accumbens",5,211,12540,12751,0.000392126107756
"Indusium griseum","Olfactory bulb",9,68,11202,11270,0.000798580301686
Claustrum,Subgranular,14,82727,618,83345,0.000167976483292
"Inferior parietal lobule","Posterior parahippocampal gyrus",3,793,38,831,0.00361010830325
"Inferior temporal","Middle frontal",65,1646,963,2609,0.0249137600613
("Mammillary body" OR "Mammillary bodies),Striatum,64,1305,58876,60181,0.00106345856666
("Mammillary body" OR "Mammillary bodies),"Ventral tegmentum",42,42,281,323,0.130030959752
(Inferior AND collicul*),"Substantia nigra",233,4050,19154,23204,0.0100413721772
"Nucleus basalis","Thalamic reticular",8,1839,592,2431,0.00329082682024
("Medial dorsal" AND nucl*),"Middle frontal",1,112,1027,1139,0.000877963125549
"Medial geniculate","Superior frontal",0,1249,1091,2340,0.0
Parahippocamp*,"Visual extrastriate",40,2619,1494,4113,0.0097252613664
Infralimbic,("Posterior nucleus" AND hypothalamus),5,491,62,553,0.00904159132007
Perirhinal,"Posterior cingulate",11,1189,1891,3080,0.00357142857143
("Locus coeruleus" OR "locus ceruleus"),Premotor,20,7619,4709,12328,0.00162232316677
"Olfactory bulb",(Raphe AND (nuclei OR nucleus)),222,10989,8099,19088,0.0116303436714
"Olfactory bulb",Suprachiasmatic,105,11106,5921,17027,0.00616667645504
("Posterior nucleus" AND hypothalamus),Pulvinar,1,66,1132,1198,0.000834724540902
"Posterior parahippocampal gyrus","Posterior parietal",0,41,2154,2195,0.0
"Posterior parahippocampal gyrus","Superior temporal",4,37,4103,4140,0.000966183574879
Perirhinal,("Ventral posterolateral" AND (nuclei OR nucleus)),0,1200,148,1348,0.0
Pineal,(Septal AND (nuclei OR nucleus)),25,14378,4635,19013,0.00131488981223
"Middle temporal",("Straight gyrus" OR "gyrus rectus"),4,1633,126,1759,0.00227401932916
"Middle temporal",Suprachiasmatic,0,1637,6026,7663,0.0
("Superior olive" OR "superior olivary"),Suprachiasmatic,6,1251,6020,7271,0.000825195984046
"Supplementary motor",("Ventral anterior" AND (nuclei OR nucleus)),12,2349,225,2574,0.004662004662
Temporoparietal,"Thalamic reticular",0,1460,600,2060,0.0
Subiculum,"Zona incerta",101,98140,873,99013,0.00102006807187
"Amygdala",Subiculum,8186,15171,90055,105226,0.0777944614449
"Amygdala","Ventral tegmentum",45,23312,240,23552,0.00191066576087
"Angular gyrus","Paracentral lobule",2,500,63,563,0.00355239786856
Cingulate,"Pontine nuclei",32,11072,766,11838,0.00270315931745
"Basal forbrain",Cerebellum,0,1,65400,65401,0.0
("Centromedian" AND (nuclei OR nucleus)),"Piriform cortex",1,215,1742,1957,0.000510986203373
"Lateral geniculate","Piriform cortex",9,5171,1734,6905,0.00130340333092
"Diagonal band of Broca","Lateral geniculate",10,885,5170,6055,0.00165152766309
Fusiform,(Medulla OR "medulla oblongata"),125,5330,50697,56027,0.00223106716405
Ambiguus,("Superior olive" OR "superior olivary"),16,1200,1241,2441,0.00655469070053
"Broca's area",("Centromedian" AND (nuclei OR nucleus)),0,694,216,910,0.0
Caudate,Pulvinar,87,18714,1046,19760,0.0044028340081
Claustrum,("Superior olive" OR "superior olivary"),20,82721,1237,83958,0.000238214345268
("Gustatory cortex" OR "gustatory area"),"Supplementary motor",1,152,2360,2512,0.000398089171975
"Dentate gyrus",Subthalam*,43,11400,4086,15486,0.00277670153687
"Dentate gyrus",("Posterior nucleus" AND hypothalamus),1,11442,66,11508,8.68960722975e-05
"Indusium griseum",("Ventral posteromedial" AND (nuclei OR nucleus)),0,77,112,189,0.0
(Cochlear AND (nuclei OR nucleus)),"Posterior parahippocampal gyrus",0,5307,41,5348,0.0
"Inferior parietal lobule",Orbitofrontal,26,770,2970,3740,0.00695187165775
"Globus pallidus",Prefrontal,245,7861,23856,31717,0.00772456411388
Hippocamp*,"Stria terminalis",465,103629,2265,105894,0.00439118363647
Hippocamp*,Thalamus,6193,97901,36689,134590,0.0460138197489
"Interstitial nucleus","Postcentral gyrus",0,514,531,1045,0.0
"Lingual gyrus","Olfactory bulb",0,254,11211,11465,0.0
("Nucleus gracilis" OR "gracile nucleus"),"Postcentral gyrus",0,374,531,905,0.0
Parahippocamp*,"Pontine nuclei",3,2656,795,3451,0.000869313242538
Parahippocamp*,("Ventral posteromedial" AND (nuclei OR nucleus)),0,2659,112,2771,0.0
"Medial geniculate",Orbitofrontal,4,1245,2992,4237,0.000944064196365
periaqueductal,"Superior frontal",2,4574,1089,5663,0.00035316969804
"Pontine nuclei","Posterior parahippocampal gyrus",1,797,40,837,0.00119474313023
"Nucleus accumbens","Substantia nigra",1354,11191,18033,29224,0.0463317820969
("Locus coeruleus" OR "locus ceruleus"),"Posterior parietal",4,7635,2150,9785,0.000408788962698
"Paracentral lobule",Perirhinal,0,65,1200,1265,0.0
"Posterior cingulate","Primary motor",34,1868,3171,5039,0.00674737051002
"Piriform cortex","Postcentral gyrus",2,1741,529,2270,0.000881057268722
"Posterior parietal","Stria terminalis",0,2154,2730,4884,0.0
Precuneus,Suprachiasmatic,0,1220,6026,7246,0.0
Subthalam*,"Superior frontal",6,4123,1085,5208,0.00115207373272
Cerebellum,"Piriform cortex",172,65228,1571,66799,0.00257488884564
"Anterior cingulate","Ventral tegmentum",3,5799,282,6081,0.000493339911199
"Calcarine fissure",(Medulla OR "medulla oblongata"),0,103,50822,50925,0.0
("Centromedian" AND (nuclei OR nucleus)),"Thalamic reticular",6,210,594,804,0.00746268656716
"Diagonal band of Broca",(Periventricular AND (nuclei OR nucleus)),80,815,2415,3230,0.0247678018576
Entorhinal,("Nucleus gracilis" OR "gracile nucleus"),0,5547,374,5921,0.0
Entorhinal,Pineal,6,5541,14397,19938,0.000300932891965
Entorhinal,(Intralaminar AND (nuclei OR nucleus)),27,5520,1073,6593,0.00409525254057
"Dorsolateral prefrontal","Nucleus accumbens",34,2970,12511,15481,0.00219624055294
"Broca's area",("Locus coeruleus" OR "locus ceruleus"),1,693,7638,8331,0.000120033609411
("Gustatory cortex" OR "gustatory area"),(Inferior AND collicul*),0,153,4283,4436,0.0
("Heschl's gyrus" OR "Transverse temporal"),"Visual cortex",24,1124,22856,23980,0.00100083402836
Claustrum,"Indusium griseum",6,82735,71,82806,7.24585174987e-05
Hypothalam*,(Intralaminar AND (nuclei OR nucleus)),147,107402,953,108355,0.00135665174657
(Cochlear AND (nuclei OR nucleus)),("Posterior nucleus" AND hypothalamus),0,5307,67,5374,0.0
Fusiform,Striatum,74,5381,58866,64247,0.00115180475353
"Indusium griseum","Posterior parahippocampal gyrus",0,77,41,118,0.0
"Inferior parietal lobule","Paracentral lobule",6,790,59,849,0.00706713780919
"Inferior parietal lobule",Infralimbic,0,796,496,1292,0.0
"Inferior parietal lobule","Nucleus accumbens",2,794,12543,13337,0.000149958761341
("Mammillary body" OR "Mammillary bodies),("Ventral anterior" AND (nuclei OR nucleus)),63,63,236,299,0.210702341137
("Nucleus gracilis" OR "gracile nucleus"),"Substantia nigra",11,363,19376,19739,0.000557272404884
"Medial geniculate","Pontine nuclei",24,1225,774,1999,0.0120060030015
Parahippocamp*,"Superior frontal",77,2582,1014,3596,0.0214126807564
(Medulla OR "medulla oblongata"),("Red nucleus"),318,50504,2058,52562,0.00604999809748
Insula*,"Piriform cortex",85,17088,1658,18746,0.00453430065081
Insula*,"Posterior parahippocampal gyrus",2,17171,39,17210,0.000116211504939
Orbitofrontal,"Pontine nuclei",3,2993,795,3788,0.000791974656811
"Paracentral lobule","Primary motor",4,61,3201,3262,0.00122624156959
Orbitofrontal,"Visual extrastriate",18,2978,1516,4494,0.00400534045394
"Posterior parahippocampal gyrus",Pulvinar,3,38,1130,1168,0.00256849315068
"Middle temporal",Precuneus,119,1518,1101,2619,0.0454371897671
"Stria terminalis","Visual extrastriate",0,2730,1534,4264,0.0
("Superior olive" OR "superior olivary"),("Ventral anterior" AND (nuclei OR nucleus)),0,1257,237,1494,0.0
("Ventral anterior" AND (nuclei OR nucleus)),"Wernicke's area",0,237,251,488,0.0
("Ventral posteromedial" AND (nuclei OR nucleus)),"Visual cortex",1,111,22879,22990,4.34971726838e-05
Pulvinar,"Stria terminalis",8,1125,2722,3847,0.00207954250065
"Amygdala",("Gustatory cortex" OR "gustatory area"),38,23319,115,23434,0.00162157548861
Ambiguus,Parahippocamp*,0,1216,2659,3875,0.0
Ambiguus,"Paracentral lobule",0,1216,65,1281,0.0
"Angular gyrus","Superior temporal",98,404,4009,4413,0.022207115341
"Angular gyrus","Medial frontal",22,480,1573,2053,0.0107160253288
"Basal forbrain","Inferior frontal",0,1,2812,2813,0.0
(Dorsomedial AND hypothal*),"Visual extrastriate",0,2139,1534,3673,0.0
(Cochlear AND (nuclei OR nucleus)),"Thalamic reticular",7,5300,593,5893,0.00118784999152
"Basal forbrain","Olfactory bulb",0,1,11211,11212,0.0
"Broca's area",(Inferior AND collicul*),0,694,4283,4977,0.0
Fusiform,Prefrontal,329,5126,23772,28898,0.0113848709253
Caudate,"Substantia nigra",2822,15979,16565,32544,0.0867133726647
("Heschl's gyrus" OR "Transverse temporal"),("Ventral anterior" AND (nuclei OR nucleus)),0,1148,237,1385,0.0
Caudate,"Supplementary motor",99,18702,2262,20964,0.00472238122496
Cingulum,"Middle temporal",9,676,1628,2304,0.00390625
(Cochlear AND (nuclei OR nucleus)),"Postcentral gyrus",0,5307,531,5838,0.0
"Indusium griseum","Inferior frontal",0,77,2812,2889,0.0
"Globus pallidus","Posterior parietal",11,8095,2143,10238,0.00107442859934
"Inferior parietal lobule","Nucleus basalis",5,791,1842,2633,0.00189897455374
"Inferior temporal","Paracentral lobule",2,1709,63,1772,0.00112866817156
"Interstitial nucleus","Middle frontal",0,514,1028,1542,0.0
(Inferior AND collicul*),Temporoparietal,1,4282,1459,5741,0.000174185681937
("Medial dorsal" AND nucl*),("Red nucleus"),3,110,2373,2483,0.0012082158679
"Nucleus basalis","Ventromedial prefrontal",0,1847,3,1850,0.0
Infralimbic,"Nucleus accumbens",108,388,12437,12825,0.00842105263158
Infralimbic,"Posterior parahippocampal gyrus",0,496,41,537,0.0
"Middle frontal",("Ventral posteromedial" AND (nuclei OR nucleus)),0,1028,112,1140,0.0
"Pontine nuclei",Suprachiasmatic,11,787,6015,6802,0.00161717142017
"Olfactory bulb",Pulvinar,1,11210,1132,12342,8.10241451953e-05
"Nucleus accumbens","Primary auditory",4,12541,1865,14406,0.000277662085242
"Posterior cingulate",("Ventral posteromedial" AND (nuclei OR nucleus)),0,1902,112,2014,0.0
"Posterior cingulate",Temporoparietal,61,1841,1399,3240,0.0188271604938
"Posterior cingulate",Premotor,79,1823,4650,6473,0.0122045419435
"Primary sensory","Supplementary motor",43,2967,2318,5285,0.0081362346263
Perirhinal,"Ventral tegmentum",2,1198,283,1481,0.00135043889264
"Primary auditory","Thalamic reticular",5,1864,595,2459,0.00203334688898
"Middle frontal",("Nucleus cuneatus" OR "cuneate nucleus"),0,1028,692,1720,0.0
"Middle temporal","Posterior parietal",59,1578,2095,3673,0.0160631636265
"Middle frontal",Operculum,19,1009,907,1916,0.00991649269311
Subgranular,Striatum,20,612,58920,59532,0.000335953772761
Temporoparietal,"Wernicke's area",10,1450,241,1691,0.00591366055588
"Superior temporal","Zona incerta",5,4102,969,5071,0.000985998816801
"Visual extrastriate","Zona incerta",2,1532,972,2504,0.000798722044728
Putamen,("Ventral posterolateral" AND (nuclei OR nucleus)),8,10741,140,10881,0.000735226541678
"Substantia nigra","Supplementary motor",28,19359,2333,21692,0.00129079845104
Subiculum,Subgranular,505,97736,127,97863,0.00516027507843
(Intralaminar AND (nuclei OR nucleus)),Suprachiasmatic,6,1094,6020,7114,0.000843407365758
(Cochlear AND (nuclei OR nucleus)),Subiculum,139,5168,98102,103270,0.00134598624964
("Centromedian" AND (nuclei OR nucleus)),"Zona incerta",12,204,962,1166,0.0102915951973
Cerebellum,"Stria terminalis",109,65291,2621,67912,0.00160501825892
Cerebellum,"Globus pallidus",755,64645,7351,71996,0.0104866937052
Entorhinal,Orbitofrontal,78,5469,2918,8387,0.00930010730893
"Dorsolateral prefrontal","Middle frontal",60,2944,968,3912,0.0153374233129
"Basal forbrain","Superior frontal",0,1,1091,1092,0.0
"Calcarine fissure",Operculum,3,100,923,1023,0.00293255131965
Fusiform,Pons,177,5278,25407,30685,0.00576829069578
Caudate,"Superior frontal",67,18734,1024,19758,0.00339103148092
Caudate,"Posterior parahippocampal gyrus",0,18801,41,18842,0.0
Claustrum,Parahippocamp*,334,82407,2325,84732,0.00394184015484
Cingulum,Temporoparietal,2,683,1458,2141,0.000934142923867
Claustrum,("Mammillary body" OR "Mammillary bodies),155,82586,1214,83800,0.00184964200477
("Inferior olive" OR "Inferior olivary"),"Thalamic reticular",5,2375,595,2970,0.0016835016835
Fusiform,"Wernicke's area",8,5447,243,5690,0.00140597539543
("Inferior olive" OR "Inferior olivary"),"Posterior cingulate",1,2379,1901,4280,0.000233644859813
Hippocamp*,(Raphe AND (nuclei OR nucleus)),1465,102629,6856,109485,0.013380828424
"Lingual gyrus",Striatum,3,251,58937,59188,5.06859498547e-05
"Inferior temporal","Supplementary motor",22,1689,2339,4028,0.00546176762661
(Intralaminar AND (nuclei OR nucleus)),"Lateral geniculate",101,999,5079,6078,0.0166173083251
("Medial dorsal" AND nucl*),"Olfactory bulb",0,113,11211,11324,0.0
("Nucleus gracilis" OR "gracile nucleus"),("Straight gyrus" OR "gyrus rectus"),0,374,130,504,0.0
Parahippocamp*,"Posterior parietal",51,2608,2103,4711,0.0108257270219
"Middle temporal",Parahippocamp*,122,1515,2537,4052,0.0301085883514
("Locus coeruleus" OR "locus ceruleus"),"Stria terminalis",284,7355,2446,9801,0.0289766350372
"Nucleus basalis",("Posterior nucleus" AND hypothalamus),0,1847,67,1914,0.0
"Posterior parahippocampal gyrus",Subthalam*,0,41,4129,4170,0.0
"Primary sensory","Visual extrastriate",7,3003,1527,4530,0.00154525386313
Pineal,"Stria terminalis",27,14376,2703,17079,0.00158088881082
Pineal,"Superior temporal",0,14403,4107,18510,0.0
Pineal,"Ventromedial prefrontal",0,14403,3,14406,0.0
("Straight gyrus" OR "gyrus rectus"),"Visual cortex",1,129,22879,23008,4.34631432545e-05
Pineal,("Ventral posteromedial" AND (nuclei OR nucleus)),0,14403,112,14515,0.0
"Ventromedial prefrontal","Ventral tegmentum",0,3,285,288,0.0
("Ventral posteromedial" AND (nuclei OR nucleus)),"Ventromedial prefrontal",0,112,3,115,0.0
Temporoparietal,"Ventral tegmentum",0,1460,285,1745,0.0
(Raphe AND (nuclei OR nucleus)),Subiculum,1397,6924,96844,103768,0.0134627245394
"Angular gyrus","Thalamic reticular",0,502,600,1102,0.0
"Anterior cingulate","Ventromedial prefrontal",0,5802,3,5805,0.0
"Basal forbrain","Diagonal band of Broca",0,1,895,896,0.0
Cingulate,Parahippocamp*,571,10533,2088,12621,0.0452420568893
(Dorsomedial AND hypothal*),"Posterior cingulate",3,2136,1899,4035,0.000743494423792
"Dorsolateral prefrontal","Indusium griseum",0,3004,77,3081,0.0
(Dorsomedial AND hypothal*),Operculum,3,2136,923,3059,0.000980712651193
"Globus pallidus",Pulvinar,19,8087,1114,9201,0.00206499293555
"Globus pallidus",(Raphe AND (nuclei OR nucleus)),166,7940,8155,16095,0.0103137620379
Caudate,Putamen,7700,11101,3049,14150,0.544169611307
Caudate,Cingulate,944,17857,10160,28017,0.0336938287468
("Gustatory cortex" OR "gustatory area"),Subgranular,0,153,632,785,0.0
Cingulum,Subgranular,1,684,631,1315,0.000760456273764
Caudate,"Visual extrastriate",12,18789,1522,20311,0.000590812860027
("Gustatory cortex" OR "gustatory area"),"Primary sensory",3,150,3007,3157,0.000950269242952
(Inferior AND collicul*),"Indusium griseum",2,4281,75,4356,0.000459136822773
Insula*,(Septal AND (nuclei OR nucleus)),52,17121,4608,21729,0.00239311519168
Insula*,("Ventral anterior" AND (nuclei OR nucleus)),11,17162,226,17388,0.000632620197838
"Nucleus basalis",Putamen,77,1770,10672,12442,0.00618871564057
"Inferior frontal","Medial geniculate",2,2810,1247,4057,0.000492975104757
periaqueductal,Suprachiasmatic,54,4522,5972,10494,0.00514579759863
periaqueductal,("Ventral anterior" AND (nuclei OR nucleus)),8,4568,229,4797,0.00166770898478
(Medulla OR "medulla oblongata"),Pons,5701,45121,19883,65004,0.0877022952434
"Middle frontal","Wernicke's area",3,1025,248,1273,0.00235663786332
"Nucleus accumbens",("Ventral posteromedial" AND (nuclei OR nucleus)),2,12543,110,12653,0.000158065280961
"Medial frontal",Subiculum,160,1435,98081,99516,0.00160778166325
"Paracentral lobule",Prefrontal,11,54,24090,24144,0.000455599734924
("Posterior nucleus" AND hypothalamus),"Visual cortex",0,67,22880,22947,0.0
"Primary sensory",Premotor,55,2955,4674,7629,0.00720933280902
"Middle temporal",("Ventral anterior" AND (nuclei OR nucleus)),1,1636,236,1872,0.000534188034188
Pineal,"Visual extrastriate",0,14403,1534,15937,0.0
"Posterior parietal","Zona incerta",4,2150,970,3120,0.00128205128205
Prefrontal,Subthalam*,107,23994,4022,28016,0.00381924614506
("Red nucleus"),Subgranular,2,2374,630,3004,0.000665778961385
Prefrontal,("Ventral posterior" AND (nuclei OR nucleus)),5,24096,351,24447,0.000204524072483
"Amygdala","Inferior parietal lobule",26,23331,770,24101,0.00107879341106
"Angular gyrus",("Heschl's gyrus" OR "Transverse temporal"),8,494,1140,1634,0.00489596083231
Cerebellum,Orbitofrontal,175,65225,2821,68046,0.00257178967169
Cingulate,(Intralaminar AND (nuclei OR nucleus)),67,11037,1033,12070,0.00555095277548
Cingulate,"Inferior temporal",203,10901,1508,12409,0.0163590942058
"Diagonal band of Broca",Striatum,77,818,58863,59681,0.0012901928587
Entorhinal,Precuneus,24,5523,1196,6719,0.00357196011311
"Calcarine fissure",("Nucleus cuneatus" OR "cuneate nucleus"),0,103,692,795,0.0
"Amygdala",Caudate,1529,21828,17272,39100,0.039104859335
Caudate,"Globus pallidus",1785,17016,6321,23337,0.0764879804602
("Gustatory cortex" OR "gustatory area"),"Ventral tegmentum",0,153,285,438,0.0
Hypothalam*,("Medial dorsal" AND nucl*),14,107535,99,107634,0.000130070423844
(Inferior AND collicul*),Infralimbic,2,4281,494,4775,0.000418848167539
Entorhinal,"Visual extrastriate",4,5543,1530,7073,0.000565530892125
Hypothalam*,"Visual cortex",265,107284,22615,129899,0.00204004649766
"Globus pallidus",Infralimbic,11,8095,485,8580,0.00128205128205
"Inferior temporal",Pons,16,1695,25568,27263,0.000586875985768
Hippocamp*,Striatum,9193,94901,49747,144648,0.063554283502
Hippocamp*,Temporoparietal,92,104002,1368,105370,0.000873113789504
"Lingual gyrus",("Superior olive" OR "superior olivary"),0,254,1257,1511,0.0
(Intralaminar AND (nuclei OR nucleus)),"Nucleus accumbens",45,1055,12500,13555,0.00331980818886
("Nucleus cuneatus" OR "cuneate nucleus"),"Pontine nuclei",24,668,774,1442,0.0166435506241
("Nucleus cuneatus" OR "cuneate nucleus"),"Primary motor",2,690,3203,3893,0.00051374261495
"Inferior temporal",(Medulla OR "medulla oblongata"),3,1708,50819,52527,5.71134844937e-05
("Nucleus gracilis" OR "gracile nucleus"),Subgranular,0,374,632,1006,0.0
"Inferior temporal","Visual extrastriate",51,1660,1483,3143,0.0162265351575
(Medulla OR "medulla oblongata"),"Piriform cortex",47,50775,1696,52471,0.00089573288102
"Olfactory bulb",Precuneus,1,11210,1219,12429,8.04569957358e-05
Operculum,Pons,11,915,25573,26488,0.000415282392027
"Nucleus accumbens",Premotor,18,12527,4711,17238,0.00104420466411
Operculum,Subthalam*,3,923,4126,5049,0.000594177064765
"Nucleus accumbens",("Red nucleus"),37,12508,2339,14847,0.00249208594329
Orbitofrontal,Pons,35,2961,25549,28510,0.00122763942476
"Piriform cortex",Putamen,125,1618,10624,12242,0.0102107498775
Striatum,Thalamus,6005,52935,36877,89812,0.0668618892798
Thalamus,"Ventral tegmentum",37,42845,248,43093,0.00085860812661
"Ventromedial prefrontal","Zona incerta",0,3,974,977,0.0
Subgranular,("Superior olive" OR "superior olivary"),0,632,1257,1889,0.0
(Raphe AND (nuclei OR nucleus)),"Supplementary motor",3,8318,2358,10676,0.000281004121394
"Inferior frontal",Perirhinal,5,2807,1195,4002,0.00124937531234
"Amygdala","Interstitial nucleus",37,23320,477,23797,0.00155481783418
"Anterior cingulate","Nucleus accumbens",222,5580,12323,17903,0.0124001563984
("Centromedian" AND (nuclei OR nucleus)),("Straight gyrus" OR "gyrus rectus"),0,216,130,346,0.0
("Centromedian" AND (nuclei OR nucleus)),"Primary motor",5,211,3200,3411,0.00146584579302
Cingulate,periaqueductal,231,10873,4345,15218,0.0151793928243
Cingulate,("Medial dorsal" AND nucl*),30,11074,0,11074,0.00270904822106
"Dorsolateral prefrontal",periaqueductal,11,2993,4565,7558,0.00145541148452
"Diagonal band of Broca",("Heschl's gyrus" OR "Transverse temporal"),0,895,1148,2043,0.0
Entorhinal,("Posterior nucleus" AND hypothalamus),4,5543,63,5606,0.000713521227257
("Gustatory cortex" OR "gustatory area"),"Nucleus accumbens",4,149,12541,12690,0.000315208825847
"Basal forbrain","Zona incerta",0,1,974,975,0.0
("Centromedian" AND (nuclei OR nucleus)),Fusiform,1,215,5454,5669,0.000176397953784
Claustrum,Cingulum,48,82693,637,83330,0.000576023040922
(Cochlear AND (nuclei OR nucleus)),Operculum,0,5307,926,6233,0.0
(Inferior AND collicul*),"Lingual gyrus",0,4283,254,4537,0.0
"Globus pallidus","Lingual gyrus",5,8101,249,8350,0.00059880239521
(Inferior AND collicul*),Putamen,130,4153,10619,14772,0.0088004332521
("Inferior olive" OR "Inferior olivary"),"Posterior parietal",3,2377,2151,4528,0.000662544169611
("Mammillary body" OR "Mammillary bodies),("Locus coeruleus" OR "locus ceruleus"),11,11,7608,7619,0.00144375902349
"Interstitial nucleus",Pulvinar,3,511,1130,1641,0.0018281535649
"Medial frontal",Parahippocamp*,74,1521,2585,4106,0.0180224062348
(Inferior AND collicul*),"Ventromedial prefrontal",0,4283,3,4286,0.0
Infralimbic,("Mammillary body" OR "Mammillary bodies),8,488,1361,1849,0.00432666306111
Parahippocamp*,"Primary sensory",9,2650,3001,5651,0.00159263847107
Pons,("Ventral posterior" AND (nuclei OR nucleus)),14,25570,342,25912,0.000540290213029
("Locus coeruleus" OR "locus ceruleus"),"Piriform cortex",81,7558,1662,9220,0.0087852494577
"Middle temporal","Olfactory bulb",2,1635,11209,12844,0.000155714730614
Insula*,Precuneus,189,16984,1031,18015,0.0104912572856
"Nucleus accumbens",(Septal AND (nuclei OR nucleus)),1081,11464,3579,15043,0.0718606660905
"Medial frontal","Primary sensory",3,1592,3007,4599,0.000652315720809
("Posterior nucleus" AND hypothalamus),Thalamus,37,30,42845,42875,0.000862973760933
("Posterior nucleus" AND hypothalamus),"Superior frontal",0,67,1091,1158,0.0
"Primary sensory",Pulvinar,8,3002,1125,4127,0.00193845408287
"Posterior cingulate","Posterior parahippocampal gyrus",4,1898,37,1935,0.00206718346253
"Posterior cingulate",("Red nucleus"),0,1902,2376,4278,0.0
"Middle frontal","Nucleus accumbens",7,1021,12538,13559,0.000516262261229
(Periventricular AND (nuclei OR nucleus)),("Posterior nucleus" AND hypothalamus),10,2485,57,2542,0.00393391030685
"Middle temporal",(Septal AND (nuclei OR nucleus)),0,1637,4660,6297,0.0
"Piriform cortex",Precuneus,2,1741,1218,2959,0.000675904021629
Striatum,Temporoparietal,20,58920,1440,60360,0.000331345261763
Prefrontal,"Supplementary motor",525,23576,1836,25412,0.0206595309303
"Amygdala",Infralimbic,149,23208,347,23555,0.00632562088729
"Amygdala",Orbitofrontal,670,22687,2326,25013,0.026786071243
"Angular gyrus","Basal forbrain",0,502,1,503,0.0
"Basal forbrain",("Centromedian" AND (nuclei OR nucleus)),0,1,216,217,0.0
"Anterior cingulate",(Superior AND collicul*),27,5775,10057,15832,0.0017054067711
"Calcarine fissure",("Mammillary body" OR "Mammillary bodies),0,103,0,103,0.0
"Dorsolateral prefrontal",("Ventral posteromedial" AND (nuclei OR nucleus)),1,3003,111,3114,0.000321130378934
"Dorsolateral prefrontal",("Gustatory cortex" OR "gustatory area"),1,3003,152,3155,0.000316957210777
"Lateral geniculate","Zona incerta",89,5091,885,5976,0.0148929049531
(Dorsomedial AND hypothal*),("Red nucleus"),23,2116,2353,4469,0.00514656522712
(Cochlear AND (nuclei OR nucleus)),"Ventromedial prefrontal",0,5307,3,5310,0.0
"Globus pallidus","Primary motor",61,8045,3144,11189,0.00545178300116
"Basal forbrain",Parahippocamp*,0,1,2659,2660,0.0
"Broca's area",("Red nucleus"),0,694,2376,3070,0.0
Caudate,"Nucleus basalis",79,18722,1768,20490,0.00385553928746
Cingulate,Striatum,1107,9997,57833,67830,0.0163202122954
Cingulum,Subiculum,139,546,98102,98648,0.00140905036088
(Cochlear AND (nuclei OR nucleus)),"Inferior parietal lobule",0,5307,796,6103,0.0
"Dentate gyrus",(Raphe AND (nuclei OR nucleus)),188,11255,8133,19388,0.00969671962038
"Dentate gyrus",Pons,122,11321,25462,36783,0.00331674958541
"Indusium griseum",Hypothalam*,20,57,107529,107586,0.000185897793393
Fusiform,"Zona incerta",11,5444,963,6407,0.00171687217106
("Locus coeruleus" OR "locus ceruleus"),"Middle frontal",3,7636,1025,8661,0.000346380325598
"Inferior temporal",Thalamus,86,1625,42796,44421,0.00193602125121
("Nucleus cuneatus" OR "cuneate nucleus"),"Ventral tegmentum",0,692,285,977,0.0
(Medulla OR "medulla oblongata"),"Posterior parietal",5,50817,2149,52966,9.44001812483e-05
"Middle frontal",Striatum,34,994,58906,59900,0.000567612687813
Insula*,"Middle temporal",141,17032,1496,18528,0.00761010362694
Operculum,Parahippocamp*,21,905,2638,3543,0.00592718035563
Pons,"Piriform cortex",43,25541,1700,27241,0.00157850299181
Perirhinal,("Ventral posterior" AND (nuclei OR nucleus)),2,1198,354,1552,0.00128865979381
"Posterior parietal",("Ventral posterolateral" AND (nuclei OR nucleus)),3,2151,145,2296,0.00130662020906
"Thalamic reticular",("Ventral posterior" AND (nuclei OR nucleus)),13,587,343,930,0.0139784946237
Thalamus,"Wernicke's area",8,42874,243,43117,0.0001855416657
"Supplementary motor",Temporoparietal,10,2351,1450,3801,0.00263088660879
Pulvinar,Subthalam*,19,1114,4110,5224,0.00363705972435
"Piriform cortex",("Straight gyrus" OR "gyrus rectus"),1,1742,129,1871,0.00053447354356
"Ventral tegmentum",("Ventral posteromedial" AND (nuclei OR nucleus)),0,285,112,397,0.0
"Amygdala","Primary auditory",24,23333,1845,25178,0.000953213122567
"Angular gyrus","Substantia nigra",1,501,19386,19887,5.02841051943e-05
"Anterior cingulate",("Heschl's gyrus" OR "Transverse temporal"),19,5783,1129,6912,0.00274884259259
"Angular gyrus",("Medial dorsal" AND nucl*),0,502,113,615,0.0
"Calcarine fissure","Interstitial nucleus",0,103,514,617,0.0
(Cochlear AND (nuclei OR nucleus)),("Red nucleus"),35,5272,2341,7613,0.0045973991856
"Anterior cingulate","Thalamic reticular",2,5800,598,6398,0.000312597686777
("Centromedian" AND (nuclei OR nucleus)),"Posterior parietal",0,216,2154,2370,0.0
("Centromedian" AND (nuclei OR nucleus)),"Stria terminalis",3,213,2727,2940,0.00102040816327
("Centromedian" AND (nuclei OR nucleus)),("Superior olive" OR "superior olivary"),0,216,1257,1473,0.0
Fusiform,("Medial dorsal" AND nucl*),0,5455,113,5568,0.0
Entorhinal,"Inferior parietal lobule",13,5534,783,6317,0.00205793889505
("Heschl's gyrus" OR "Transverse temporal"),(Raphe AND (nuclei OR nucleus)),0,1148,8321,9469,0.0
Cingulate,("Ventral posterolateral" AND (nuclei OR nucleus)),4,11100,144,11244,0.000355745286375
("Centromedian" AND (nuclei OR nucleus)),(Medulla OR "medulla oblongata"),6,210,50816,51026,0.000117587112452
Claustrum,"Globus pallidus",6569,76172,1537,77709,0.0845333230385
"Dentate gyrus","Posterior parietal",4,11439,2150,13589,0.000294355728898
Caudate,Hippocamp*,3105,15696,100989,116685,0.0266101041265
Hypothalam*,"Stria terminalis",1657,105892,1073,106965,0.0154910484738
"Indusium griseum",Subgranular,0,77,632,709,0.0
Claustrum,"Substantia nigra",8669,74072,10718,84790,0.102240830287
"Indusium griseum","Visual cortex",1,76,22879,22955,4.35634937922e-05
"Globus pallidus","Paracentral lobule",2,8104,63,8167,0.000244887963757
"Inferior temporal",Subiculum,226,1485,98015,99500,0.00227135678392
(Intralaminar AND (nuclei OR nucleus)),"Middle temporal",3,1097,1634,2731,0.00109849871842
Hippocamp*,"Superior temporal",365,103729,3742,107471,0.00339626503894
("Medial dorsal" AND nucl*),Orbitofrontal,5,108,2991,3099,0.00161342368506
"Medial frontal",(Medulla OR "medulla oblongata"),9,1586,50813,52399,0.000171759003034
("Mammillary body" OR "Mammillary bodies),("Ventral posterolateral" AND (nuclei OR nucleus)),2,2,148,150,0.0133333333333
Parahippocamp*,("Ventral posterolateral" AND (nuclei OR nucleus)),1,2658,147,2805,0.000356506238859
("Medial dorsal" AND nucl*),Subthalam*,3,110,4126,4236,0.00070821529745
"Middle temporal",Operculum,17,1620,909,2529,0.00672202451562
"Postcentral gyrus",Putamen,25,506,10724,11230,0.00222617987533
"Nucleus accumbens","Ventromedial prefrontal",0,12545,3,12548,0.0
"Paracentral lobule",Suprachiasmatic,0,65,6026,6091,0.0
Orbitofrontal,"Ventromedial prefrontal",0,2996,3,2999,0.0
Pons,(Superior AND collicul*),669,24915,9415,34330,0.0194873288669
"Medial frontal",("Posterior nucleus" AND hypothalamus),1,1594,66,1660,0.000602409638554
"Posterior parahippocampal gyrus","Ventromedial prefrontal",0,41,3,44,0.0
Precuneus,"Visual extrastriate",15,1205,1519,2724,0.00550660792952
"Substantia nigra",("Ventral posteromedial" AND (nuclei OR nucleus)),2,19385,110,19495,0.000102590407797
"Amygdala","Globus pallidus",581,22776,7525,30301,0.0191742846771
Ambiguus,Hippocamp*,39,1177,104055,105232,0.000370609700471
"Anterior cingulate",("Locus coeruleus" OR "locus ceruleus"),40,5762,7599,13361,0.00299378789013
Cingulate,"Olfactory bulb",124,10980,11087,22067,0.00561925046449
"Diagonal band of Broca",Pineal,4,891,14399,15290,0.000261608894702
"Diagonal band of Broca",Hippocamp*,319,576,103775,104351,0.00305699034988
Fusiform,Orbitofrontal,77,5378,2919,8297,0.00928046281789
(Dorsomedial AND hypothal*),"Lingual gyrus",0,2139,254,2393,0.0
Fusiform,"Primary motor",13,5442,3192,8634,0.00150567523743
"Broca's area","Inferior parietal lobule",16,678,780,1458,0.0109739368999
Caudate,Premotor,166,18635,4563,23198,0.00715578929218
("Centromedian" AND (nuclei OR nucleus)),"Globus pallidus",35,181,8071,8252,0.00424139602521
("Heschl's gyrus" OR "Transverse temporal"),"Postcentral gyrus",10,1138,521,1659,0.00602772754671
Claustrum,"Primary motor",274,82467,2931,85398,0.00320850605401
"Indusium griseum","Medial geniculate",0,77,1249,1326,0.0
(Cochlear AND (nuclei OR nucleus)),"Posterior cingulate",1,5306,1901,7207,0.000138753989177
Hypothalam*,Orbitofrontal,148,107401,2848,110249,0.00134241580422
Entorhinal,"Superior temporal",70,5477,4037,9514,0.00735757830565
"Diagonal band of Broca","Dentate gyrus",38,857,11405,12262,0.00309900505627
"Globus pallidus",("Mammillary body" OR "Mammillary bodies),30,8076,30,8106,0.00370096225019
(Inferior AND collicul*),Prefrontal,36,4247,24065,28312,0.00127154563436
("Locus coeruleus" OR "locus ceruleus"),"Zona incerta",101,7538,873,8411,0.0120080846511
("Nucleus cuneatus" OR "cuneate nucleus"),"Primary sensory",11,681,2999,3680,0.00298913043478
"Interstitial nucleus",Insula*,5,509,17168,17677,0.000282853425355
(Medulla OR "medulla oblongata"),("Posterior nucleus" AND hypothalamus),8,50814,59,50873,0.000157254339237
("Locus coeruleus" OR "locus ceruleus"),Pineal,40,7599,14363,21962,0.00182132774793
Operculum,("Ventral anterior" AND (nuclei OR nucleus)),1,925,236,1161,0.000861326442722
"Nucleus basalis",Pineal,2,1845,14401,16246,0.000123107226394
Orbitofrontal,Pulvinar,19,2977,1114,4091,0.00464434123686
("Posterior nucleus" AND hypothalamus),(Raphe AND (nuclei OR nucleus)),6,61,8315,8376,0.000716332378223
Prefrontal,"Visual extrastriate",121,23980,1413,25393,0.00476509274209
"Olfactory bulb",("Ventral anterior" AND (nuclei OR nucleus)),6,11205,231,11436,0.000524658971668
(Periventricular AND (nuclei OR nucleus)),"Thalamic reticular",3,2492,597,3089,0.000971188086759
(Periventricular AND (nuclei OR nucleus)),("Red nucleus"),14,2481,2362,4843,0.00289077018377
"Primary sensory",("Superior olive" OR "superior olivary"),4,3006,1253,4259,0.000939187602724
("Ventral posterolateral" AND (nuclei OR nucleus)),"Ventral tegmentum",0,148,285,433,0.0
"Ventral tegmentum","Visual cortex",2,283,22878,23161,8.63520573378e-05
"Medial frontal","Pontine nuclei",1,1594,797,2391,0.000418235048097
Ambiguus,"Primary sensory",4,1212,3006,4218,0.00094831673779
Ambiguus,Striatum,9,1207,58931,60138,0.000149655791679
Cingulate,"Nucleus accumbens",526,10578,12019,22597,0.023277426207
"Calcarine fissure","Inferior temporal",1,102,1710,1812,0.000551876379691
(Cochlear AND (nuclei OR nucleus)),"Superior temporal",1,5306,4106,9412,0.000106247343816
"Diagonal band of Broca","Piriform cortex",19,876,1724,2600,0.00730769230769
"Dentate gyrus",Fusiform,29,11414,5426,16840,0.00172209026128
(Dorsomedial AND hypothal*),"Primary auditory",0,2139,1869,4008,0.0
("Gustatory cortex" OR "gustatory area"),"Globus pallidus",0,153,8106,8259,0.0
("Gustatory cortex" OR "gustatory area"),"Postcentral gyrus",1,152,530,682,0.00146627565982
("Heschl's gyrus" OR "Transverse temporal"),"Stria terminalis",1,1147,2729,3876,0.000257997936017
"Amygdala",(Cochlear AND (nuclei OR nucleus)),55,23302,5252,28554,0.00192617496673
"Calcarine fissure",("Red nucleus"),0,103,2376,2479,0.0
Cingulum,("Nucleus cuneatus" OR "cuneate nucleus"),0,685,692,1377,0.0
(Cochlear AND (nuclei OR nucleus)),("Locus coeruleus" OR "locus ceruleus"),67,5240,7572,12812,0.00522947236965
Claustrum,"Thalamic reticular",53,82688,547,83235,0.000636751366613
Claustrum,"Interstitial nucleus",40,82701,474,83175,0.000480913736099
"Indusium griseum",Subthalam*,0,77,4129,4206,0.0
"Globus pallidus","Medial frontal",10,8096,1585,9681,0.00103295114141
"Lingual gyrus",("Ventral posterior" AND (nuclei OR nucleus)),0,254,356,610,0.0
("Mammillary body" OR "Mammillary bodies),Subiculum,389,980,97852,98832,0.00393597215477
"Medial frontal",periaqueductal,11,1584,4565,6149,0.00178890876565
(Intralaminar AND (nuclei OR nucleus)),Operculum,3,1097,923,2020,0.00148514851485
("Nucleus cuneatus" OR "cuneate nucleus"),Striatum,14,678,58926,59604,0.000234883564861
"Inferior frontal","Posterior cingulate",138,2674,1764,4438,0.0310950878774
"Medial geniculate",Precuneus,1,1248,1219,2467,0.000405350628293
"Pontine nuclei",("Ventral anterior" AND (nuclei OR nucleus)),2,796,235,1031,0.00193986420951
Perirhinal,"Primary sensory",9,1191,3001,4192,0.00214694656489
(Medulla OR "medulla oblongata"),("Ventral posterior" AND (nuclei OR nucleus)),19,50803,337,51140,0.000371529135706
"Nucleus accumbens","Piriform cortex",123,12422,1620,14042,0.00875943597778
"Nucleus accumbens",Operculum,1,12544,925,13469,7.42445615859e-05
"Nucleus basalis","Piriform cortex",14,1833,1729,3562,0.00393037619315
Orbitofrontal,"Primary auditory",2,2994,1867,4861,0.000411437975725
"Posterior cingulate",Subthalam*,6,1896,4123,6019,0.000996843329457
Premotor,"Superior frontal",53,4676,1038,5714,0.00927546377319
"Middle temporal",("Posterior nucleus" AND hypothalamus),0,1637,67,1704,0.0
Pineal,"Supplementary motor",0,14403,2361,16764,0.0
Striatum,("Ventral posteromedial" AND (nuclei OR nucleus)),5,58935,107,59042,8.46854781342e-05
Subthalam*,"Zona incerta",228,3901,746,4647,0.0490639122014
(Septal AND (nuclei OR nucleus)),Striatum,711,3949,58229,62178,0.0114349126701
"Primary motor",Suprachiasmatic,2,3203,6024,9227,0.00021675517503
Temporoparietal,"Visual cortex",26,1434,22854,24288,0.00107048748353
"Primary motor","Thalamic reticular",2,3203,598,3801,0.000526177321757
("Superior olive" OR "superior olivary"),("Ventral posteromedial" AND (nuclei OR nucleus)),0,1257,112,1369,0.0
(Raphe AND (nuclei OR nucleus)),(Superior AND collicul*),318,8003,9766,17769,0.0178963363161
Ambiguus,"Calcarine fissure",0,1216,103,1319,0.0
Ambiguus,Orbitofrontal,0,1216,2996,4212,0.0
"Anterior cingulate","Visual cortex",176,5626,22704,28330,0.00621249558772
"Basal forbrain",Hippocamp*,0,1,104094,104095,0.0
"Lateral geniculate","Medial frontal",2,5178,1593,6771,0.000295377344558
"Angular gyrus",Insula*,48,454,17125,17579,0.00273053074691
Cerebellum,"Primary sensory",77,65323,2933,68256,0.00112810595406
(Intralaminar AND (nuclei OR nucleus)),"Wernicke's area",0,1100,251,1351,0.0
"Globus pallidus","Supplementary motor",73,8033,2288,10321,0.0070729580467
("Gustatory cortex" OR "gustatory area"),("Nucleus gracilis" OR "gracile nucleus"),0,153,374,527,0.0
("Heschl's gyrus" OR "Transverse temporal"),Premotor,10,1138,4719,5857,0.00170735871607
("Heschl's gyrus" OR "Transverse temporal"),Suprachiasmatic,1,1147,6025,7172,0.000139431121026
Caudate,("Red nucleus"),171,18630,2205,20835,0.00820734341253
Caudate,Subgranular,4,18797,628,19425,0.00020592020592
Caudate,("Ventral posteromedial" AND (nuclei OR nucleus)),5,18796,107,18903,0.000264508279109
"Dentate gyrus",Operculum,0,11443,926,12369,0.0
"Indusium griseum","Posterior cingulate",1,76,1901,1977,0.000505816894284
Hypothalam*,"Visual extrastriate",2,107547,1532,109079,1.83353349407e-05
"Interstitial nucleus",("Ventral posterolateral" AND (nuclei OR nucleus)),3,511,145,656,0.00457317073171
("Mammillary body" OR "Mammillary bodies),("Ventral posterior" AND (nuclei OR nucleus)),49,49,356,405,0.120987654321
"Medial geniculate","Substantia nigra",77,1172,19310,20482,0.00375939849624
(Inferior AND collicul*),("Ventral posterolateral" AND (nuclei OR nucleus)),3,4280,145,4425,0.000677966101695
"Postcentral gyrus","Posterior parahippocampal gyrus",0,531,41,572,0.0
"Middle temporal",(Periventricular AND (nuclei OR nucleus)),1,1636,2494,4130,0.000242130750605
(Medulla OR "medulla oblongata"),("Straight gyrus" OR "gyrus rectus"),4,50818,126,50944,7.85175879397e-05
"Medial frontal","Visual cortex",34,1561,22846,24407,0.00139304297947
"Posterior parahippocampal gyrus","Supplementary motor",0,41,2361,2402,0.0
(Periventricular AND (nuclei OR nucleus)),"Ventral tegmentum",6,2489,279,2768,0.0021676300578
"Posterior cingulate",("Ventral posterior" AND (nuclei OR nucleus)),0,1902,356,2258,0.0
"Stria terminalis",("Ventral anterior" AND (nuclei OR nucleus)),6,2724,231,2955,0.00203045685279
"Ventral tegmentum","Wernicke's area",0,285,251,536,0.0
Pulvinar,("Ventral anterior" AND (nuclei OR nucleus)),27,1106,210,1316,0.0205167173252
"Primary motor",("Ventral posterolateral" AND (nuclei OR nucleus)),4,3201,144,3345,0.00119581464873
"Amygdala",periaqueductal,601,22756,3975,26731,0.0224832591373
"Angular gyrus","Stria terminalis",0,502,2730,3232,0.0
"Anterior cingulate",(Inferior AND collicul*),14,5788,4269,10057,0.0013920652282
"Angular gyrus",Cingulum,2,500,683,1183,0.00169061707523
Cerebellum,"Visual extrastriate",32,65368,1502,66870,0.000478540451623
Cerebellum,"Superior frontal",134,65266,957,66223,0.00202346616734
"Lateral geniculate",Putamen,44,5136,10705,15841,0.00277760242409
"Basal forbrain",Entorhinal,0,1,5547,5548,0.0
("Centromedian" AND (nuclei OR nucleus)),"Visual extrastriate",0,216,1534,1750,0.0
"Lateral geniculate","Superior temporal",16,5164,4091,9255,0.00172879524581
"Diagonal band of Broca",Subgranular,0,895,632,1527,0.0
"Basal forbrain","Medial frontal",0,1,1595,1596,0.0
"Calcarine fissure","Supplementary motor",0,103,2361,2464,0.0
"Calcarine fissure",Striatum,1,102,58939,59041,1.69373824969e-05
("Heschl's gyrus" OR "Transverse temporal"),"Medial frontal",5,1143,1590,2733,0.00182949140139
Cingulate,"Stria terminalis",133,10971,2597,13568,0.00980247641509
"Dentate gyrus","Posterior cingulate",21,11422,1881,13303,0.0015785912952
Hippocamp*,"Primary auditory",30,104064,1839,105903,0.000283278094105
"Lingual gyrus",("Posterior nucleus" AND hypothalamus),0,254,67,321,0.0
(Intralaminar AND (nuclei OR nucleus)),(Medulla OR "medulla oblongata"),45,1055,50777,51832,0.000868189535422
"Globus pallidus","Posterior cingulate",24,8082,1878,9960,0.00240963855422
("Medial dorsal" AND nucl*),"Paracentral lobule",0,113,65,178,0.0
(Inferior AND collicul*),Subiculum,366,3917,97875,101792,0.00359556743163
("Nucleus gracilis" OR "gracile nucleus"),Subthalam*,2,372,4127,4499,0.000444543231829
"Medial geniculate",Temporoparietal,2,1247,1458,2705,0.000739371534196
"Medial geniculate",("Red nucleus"),15,1234,2361,3595,0.00417246175243
("Locus coeruleus" OR "locus ceruleus"),("Superior olive" OR "superior olivary"),30,7609,1227,8836,0.00339520144862
Premotor,(Septal AND (nuclei OR nucleus)),0,4729,4660,9389,0.0
"Middle frontal",periaqueductal,1,1027,4575,5602,0.00017850767583
Striatum,(Superior AND collicul*),490,58450,9594,68044,0.00720122273823
"Stria terminalis","Substantia nigra",167,2563,19220,21783,0.00766652894459
"Superior temporal","Thalamic reticular",1,4106,599,4705,0.000212539851222
Ambiguus,Caudate,19,1197,18782,19979,0.000950998548476
Cerebellum,(Superior AND collicul*),797,64603,9287,73890,0.0107863039654
(Intralaminar AND (nuclei OR nucleus)),periaqueductal,57,1043,4519,5562,0.0102481121899
"Dorsolateral prefrontal","Posterior cingulate",119,2885,1783,4668,0.0254927163668
(Dorsomedial AND hypothal*),("Gustatory cortex" OR "gustatory area"),0,2139,153,2292,0.0
"Dorsolateral prefrontal",Hypothalam*,33,2971,107516,110487,0.000298677672486
"Basal forbrain",(Medulla OR "medulla oblongata"),1,0,50821,50821,1.96769052163e-05
Fusiform,"Postcentral gyrus",28,5427,503,5930,0.00472175379427
"Globus pallidus",Subiculum,835,7271,97406,104677,0.0079769194761
"Basal forbrain",Precuneus,0,1,1220,1221,0.0
Entorhinal,Pulvinar,8,5539,1125,6664,0.00120048019208
("Gustatory cortex" OR "gustatory area"),Pons,11,142,25573,25715,0.000427765895392
Caudate,Hypothalam*,1899,16902,105650,122552,0.0154954631503
Cingulum,"Inferior parietal lobule",6,679,790,1469,0.00408441116406
("Gustatory cortex" OR "gustatory area"),("Ventral anterior" AND (nuclei OR nucleus)),0,153,237,390,0.0
"Dentate gyrus","Inferior temporal",18,11425,1693,13118,0.0013721603903
"Indusium griseum","Superior temporal",0,77,4107,4184,0.0
Claustrum,(Inferior AND collicul*),191,82550,4092,86642,0.00220447358094
"Inferior frontal",Temporoparietal,59,2753,1401,4154,0.0142031776601
"Inferior frontal","Ventral tegmentum",1,2811,284,3095,0.00032310177706
"Globus pallidus",(Inferior AND collicul*),84,8022,4199,12221,0.00687341461419
"Interstitial nucleus",("Red nucleus"),80,434,2296,2730,0.029304029304
("Medial dorsal" AND nucl*),"Zona incerta",6,107,968,1075,0.00558139534884
"Medial frontal",Pons,22,1573,25562,27135,0.000810761009766
periaqueductal,(Periventricular AND (nuclei OR nucleus)),145,4431,2350,6781,0.0213832768028
Parahippocamp*,("Ventral posterior" AND (nuclei OR nucleus)),0,2659,356,3015,0.0
Infralimbic,"Olfactory bulb",9,487,11202,11689,0.000769954658226
(Medulla OR "medulla oblongata"),"Nucleus basalis",76,50746,1771,52517,0.00144715044652
Perirhinal,Prefrontal,129,1071,23972,25043,0.00515114003913
"Pontine nuclei",Prefrontal,14,784,24087,24871,0.000562904587672
Operculum,Orbitofrontal,47,879,2949,3828,0.0122779519331
"Olfactory bulb","Posterior parietal",3,11208,2151,13359,0.000224567707164
"Paracentral lobule","Posterior parahippocampal gyrus",0,65,41,106,0.0
Pons,"Primary motor",38,25546,3167,28713,0.00132344234319
Pons,Putamen,371,25213,10378,35591,0.0104239835914
Pineal,Subgranular,0,14403,632,15035,0.0
("Straight gyrus" OR "gyrus rectus"),"Stria terminalis",2,128,2728,2856,0.000700280112045
"Primary motor",("Superior olive" OR "superior olivary"),0,3205,1257,4462,0.0
Temporoparietal,Suprachiasmatic,0,1460,6026,7486,0.0
Putamen,("Straight gyrus" OR "gyrus rectus"),4,10745,126,10871,0.000367951430411
Putamen,"Ventral tegmentum",24,10725,261,10986,0.00218459858001
(Raphe AND (nuclei OR nucleus)),"Wernicke's area",0,8321,251,8572,0.0
Subiculum,"Visual extrastriate",42,98199,1492,99691,0.000421301822632
Subthalam*,"Thalamic reticular",15,4114,585,4699,0.0031921685465
Ambiguus,Infralimbic,4,1212,492,1704,0.00234741784038
Ambiguus,Insula*,10,1206,17163,18369,0.000544395448854
"Anterior cingulate",("Ventral posterior" AND (nuclei OR nucleus)),6,5796,350,6146,0.000976244712008
"Dorsolateral prefrontal","Olfactory bulb",1,3003,11210,14213,7.03581228453e-05
(Dorsomedial AND hypothal*),("Ventral posterior" AND (nuclei OR nucleus)),6,2133,350,2483,0.0024164317358
(Dorsomedial AND hypothal*),"Inferior frontal",2,2137,2810,4947,0.00040428542551
("Gustatory cortex" OR "gustatory area"),"Piriform cortex",2,151,1741,1892,0.00105708245243
"Broca's area",(Septal AND (nuclei OR nucleus)),1,693,4659,5352,0.000186846038864
Caudate,(Intralaminar AND (nuclei OR nucleus)),122,18679,978,19657,0.00620644045378
(Dorsomedial AND hypothal*),"Supplementary motor",1,2138,2360,4498,0.00022232103157
Caudate,("Straight gyrus" OR "gyrus rectus"),5,18796,125,18921,0.000264256646055
Caudate,"Thalamic reticular",16,18785,584,19369,0.000826062264443
Cingulate,("Ventral anterior" AND (nuclei OR nucleus)),20,11084,217,11301,0.00176975488895
Cingulum,Claustrum,48,637,82693,83330,0.000576023040922
(Cochlear AND (nuclei OR nucleus)),Claustrum,77,5230,82664,87894,0.000876055248367
"Indusium griseum",Insula*,0,77,17173,17250,0.0
(Inferior AND collicul*),Premotor,30,4253,4699,8952,0.00335120643432
("Inferior olive" OR "Inferior olivary"),("Nucleus cuneatus" OR "cuneate nucleus"),59,2321,633,2954,0.0199729180772
"Inferior frontal","Thalamic reticular",0,2812,600,3412,0.0
"Dentate gyrus",("Mammillary body" OR "Mammillary bodies),37,11406,39,11445,0.00323285277414
Hippocamp*,Prefrontal,3594,100500,20507,121007,0.029700761113
"Interstitial nucleus",Prefrontal,8,506,24093,24599,0.000325216472214
("Medial dorsal" AND nucl*),("Nucleus cuneatus" OR "cuneate nucleus"),1,112,691,803,0.00124533001245
Parahippocamp*,Premotor,52,2607,4677,7284,0.00713893465129
Parahippocamp*,("Red nucleus"),3,2656,2373,5029,0.000596540067608
Infralimbic,"Posterior cingulate",3,493,1899,2392,0.00125418060201
"Middle frontal",Subthalam*,2,1026,4127,5153,0.000388123423249
Perirhinal,Premotor,14,1186,4715,5901,0.00237247924081
"Pontine nuclei",("Straight gyrus" OR "gyrus rectus"),0,798,130,928,0.0
(Medulla OR "medulla oblongata"),"Superior frontal",6,50816,1085,51901,0.000115604708965
"Postcentral gyrus",Subgranular,0,531,632,1163,0.0
"Postcentral gyrus",Subthalam*,1,530,4128,4658,0.000214684413912
"Primary auditory",("Ventral posterolateral" AND (nuclei OR nucleus)),0,1869,148,2017,0.0
"Middle frontal","Posterior parahippocampal gyrus",0,1028,41,1069,0.0
Precuneus,("Red nucleus"),5,1215,2371,3586,0.00139431121026
Thalamus,("Ventral posterior" AND (nuclei OR nucleus)),315,42567,41,42608,0.00739297784454
Precuneus,("Ventral posteromedial" AND (nuclei OR nucleus)),0,1220,112,1332,0.0
("Gustatory cortex" OR "gustatory area"),"Middle frontal",0,153,1028,1181,0.0
"Medial geniculate","Supplementary motor",2,1247,2359,3606,0.000554631170272
Ambiguus,"Middle frontal",0,1216,1028,2244,0.0
"Amygdala",(Intralaminar AND (nuclei OR nucleus)),109,23248,991,24239,0.00449688518503
"Amygdala",("Nucleus gracilis" OR "gracile nucleus"),8,23349,366,23715,0.00033733923677
"Angular gyrus","Nucleus accumbens",1,501,12544,13045,7.66577232656e-05
"Calcarine fissure",("Inferior olive" OR "Inferior olivary"),0,103,2380,2483,0.0
Cerebellum,("Superior olive" OR "superior olivary"),68,65332,1189,66521,0.00102223358037
(Intralaminar AND (nuclei OR nucleus)),"Primary sensory",6,1094,3004,4098,0.00146412884334
(Dorsomedial AND hypothal*),"Pontine nuclei",14,2125,784,2909,0.00481265039532
"Dorsolateral prefrontal","Pontine nuclei",2,3002,796,3798,0.000526592943655
"Dorsolateral prefrontal",(Superior AND collicul*),17,2987,10067,13054,0.00130228282519
Fusiform,"Paracentral lobule",4,5451,61,5512,0.000725689404935
(Dorsomedial AND hypothal*),("Medial dorsal" AND nucl*),4,2135,109,2244,0.0017825311943
Entorhinal,("Heschl's gyrus" OR "Transverse temporal"),16,5531,1132,6663,0.0024013207264
Entorhinal,Insula*,211,5336,16962,22298,0.00946273208359
"Broca's area",Insula*,74,620,17099,17719,0.00417630791805
"Broca's area",Temporoparietal,10,684,1450,2134,0.00468603561387
Cingulum,(Intralaminar AND (nuclei OR nucleus)),6,679,1094,1773,0.00338409475465
("Centromedian" AND (nuclei OR nucleus)),"Medial geniculate",5,211,1244,1455,0.00343642611684
(Cochlear AND (nuclei OR nucleus)),"Lateral geniculate",24,5283,5156,10439,0.00229907079222
("Centromedian" AND (nuclei OR nucleus)),(Inferior AND collicul*),7,209,4276,4485,0.0015607580825
Claustrum,(Intralaminar AND (nuclei OR nucleus)),323,82418,777,83195,0.00388244485847
"Dentate gyrus","Thalamic reticular",8,11435,592,12027,0.00066517003409
"Dentate gyrus","Nucleus accumbens",206,11237,12339,23576,0.00873769935528
Claustrum,"Primary sensory",94,82647,2916,85563,0.00109860570574
"Inferior temporal","Inferior parietal lobule",48,1663,748,2411,0.0199087515554
(Intralaminar AND (nuclei OR nucleus)),("Nucleus cuneatus" OR "cuneate nucleus"),2,1098,690,1788,0.00111856823266
("Medial dorsal" AND nucl*),"Supplementary motor",3,110,2358,2468,0.00121555915721
"Lingual gyrus","Superior frontal",25,229,1066,1295,0.019305019305
("Inferior olive" OR "Inferior olivary"),(Periventricular AND (nuclei OR nucleus)),37,2343,2458,4801,0.00770672776505
("Nucleus cuneatus" OR "cuneate nucleus"),("Ventral posterolateral" AND (nuclei OR nucleus)),5,687,143,830,0.00602409638554
(Inferior AND collicul*),"Superior frontal",0,4283,1091,5374,0.0
("Locus coeruleus" OR "locus ceruleus"),("Mammillary body" OR "Mammillary bodies),31,7608,11,7619,0.00406877542985
("Nucleus gracilis" OR "gracile nucleus"),("Red nucleus"),13,361,2363,2724,0.00477239353891
"Inferior frontal",Precuneus,157,2655,1063,3718,0.0422270037655
"Medial geniculate",Perirhinal,24,1225,1176,2401,0.00999583506872
periaqueductal,Thalamus,648,3928,42234,46162,0.0140375200381
(Medulla OR "medulla oblongata"),Orbitofrontal,9,50813,2987,53800,0.000167286245353
("Locus coeruleus" OR "locus ceruleus"),Parahippocamp*,30,7609,2629,10238,0.00293025981637
("Locus coeruleus" OR "locus ceruleus"),Prefrontal,253,7386,23848,31234,0.00810014727541
("Locus coeruleus" OR "locus ceruleus"),"Thalamic reticular",13,7626,587,8213,0.0015828564471
"Pontine nuclei","Zona incerta",32,766,942,1708,0.0187353629977
"Medial frontal","Ventromedial prefrontal",0,1595,3,1598,0.0
"Paracentral lobule",(Periventricular AND (nuclei OR nucleus)),0,65,2495,2560,0.0
"Posterior parahippocampal gyrus",Subiculum,23,18,98218,98236,0.000234130054155
("Posterior nucleus" AND hypothalamus),Subiculum,9,58,98232,98290,9.15657747482e-05
("Superior olive" OR "superior olivary"),"Visual extrastriate",0,1257,1534,2791,0.0
"Amygdala",("Ventral anterior" AND (nuclei OR nucleus)),27,23330,210,23540,0.00114698385726
(Intralaminar AND (nuclei OR nucleus)),Pineal,2,1098,14401,15499,0.000129040583263
Cerebellum,("Heschl's gyrus" OR "Transverse temporal"),46,65354,1102,66456,0.000692187311906
(Dorsomedial AND hypothal*),Pineal,29,2110,14374,16484,0.00175928172774
"Diagonal band of Broca","Middle temporal",0,895,1637,2532,0.0
Entorhinal,"Indusium griseum",7,5540,70,5610,0.00124777183601
Entorhinal,"Piriform cortex",231,5316,1512,6828,0.0338312829525
"Calcarine fissure","Postcentral gyrus",0,103,531,634,0.0
("Heschl's gyrus" OR "Transverse temporal"),(Intralaminar AND (nuclei OR nucleus)),0,1148,1100,2248,0.0
("Heschl's gyrus" OR "Transverse temporal"),Pulvinar,2,1146,1131,2277,0.000878348704436
"Broca's area","Visual extrastriate",3,691,1531,2222,0.0013501350135
"Globus pallidus","Ventromedial prefrontal",0,8106,3,8109,0.0
Claustrum,Perirhinal,258,82483,942,83425,0.00309259814204
Cingulum,Hypothalam*,35,650,107514,108164,0.00032358270774
"Inferior parietal lobule",Pons,10,786,25574,26360,0.000379362670713
"Inferior frontal",("Ventral posterolateral" AND (nuclei OR nucleus)),0,2812,148,2960,0.0
("Inferior olive" OR "Inferior olivary"),"Wernicke's area",0,2380,251,2631,0.0
"Inferior parietal lobule",(Septal AND (nuclei OR nucleus)),0,796,4660,5456,0.0
"Interstitial nucleus",(Superior AND collicul*),85,429,9999,10428,0.00815113156885
Insula*,(Superior AND collicul*),68,17105,10016,27121,0.00250728217986
("Medial dorsal" AND nucl*),"Primary motor",1,112,3204,3316,0.000301568154403
periaqueductal,"Piriform cortex",31,4545,1712,6257,0.00495445101486
"Inferior frontal","Primary sensory",9,2803,3001,5804,0.00155065472088
("Nucleus gracilis" OR "gracile nucleus"),("Posterior nucleus" AND hypothalamus),0,374,67,441,0.0
Perirhinal,(Periventricular AND (nuclei OR nucleus)),5,1195,2490,3685,0.00135685210312
(Medulla OR "medulla oblongata"),(Periventricular AND (nuclei OR nucleus)),221,50601,2274,52875,0.00417966903073
(Medulla OR "medulla oblongata"),"Primary sensory",99,50723,2911,53634,0.00184584405414
Infralimbic,"Ventral tegmentum",0,496,285,781,0.0
"Middle frontal",Perirhinal,3,1025,1197,2222,0.0013501350135
("Red nucleus"),Thalamus,487,1889,42395,44284,0.0109971998916
"Stria terminalis",Subgranular,1,2729,631,3360,0.000297619047619
"Posterior parietal","Substantia nigra",12,2142,19375,21517,0.000557698563926
"Middle temporal",Temporoparietal,26,1611,1434,3045,0.00853858784893
"Supplementary motor","Thalamic reticular",0,2361,600,2961,0.0
"Primary motor",Thalamus,248,2957,42634,45591,0.00543967011033
("Ventral anterior" AND (nuclei OR nucleus)),"Ventral tegmentum",0,237,285,522,0.0
"Ventral tegmentum","Zona incerta",3,282,971,1253,0.0023942537909
Subthalam*,"Substantia nigra",933,3196,18454,21650,0.0430946882217
Putamen,"Visual cortex",98,10651,22782,33433,0.00293123560554
("Red nucleus"),"Substantia nigra",433,1943,18954,20897,0.0207206776092
Putamen,("Red nucleus"),128,10621,2248,12869,0.00994638278032
Subthalam*,"Supplementary motor",45,4084,2316,6400,0.00703125
Cingulate,("Locus coeruleus" OR "locus ceruleus"),171,10933,7468,18401,0.00929297320798
Cerebellum,"Substantia nigra",1356,64044,18031,82075,0.0165214742613
Cingulate,Perirhinal,126,10978,1074,12052,0.010454696316
("Centromedian" AND (nuclei OR nucleus)),Temporoparietal,0,216,1460,1676,0.0
"Diagonal band of Broca",Prefrontal,31,864,24070,24934,0.00124328226518
(Dorsomedial AND hypothal*),"Inferior parietal lobule",0,2139,796,2935,0.0
"Diagonal band of Broca",(Inferior AND collicul*),12,883,4271,5154,0.0023282887078
Ambiguus,"Superior frontal",0,1216,1091,2307,0.0
"Broca's area","Postcentral gyrus",4,690,527,1217,0.00328677074774
("Gustatory cortex" OR "gustatory area"),"Indusium griseum",0,153,77,230,0.0
Ambiguus,Subiculum,37,1179,98204,99383,0.00037229707294
Claustrum,Premotor,540,82201,4189,86390,0.00625072346336
"Indusium griseum","Primary motor",0,77,3205,3282,0.0
"Indusium griseum","Superior frontal",0,77,1091,1168,0.0
Hypothalam*,"Postcentral gyrus",7,107542,524,108066,6.47752299521e-05
("Inferior olive" OR "Inferior olivary"),"Nucleus basalis",5,2375,1842,4217,0.00118567702158
"Inferior frontal",Suprachiasmatic,0,2812,6026,8838,0.0
("Inferior olive" OR "Inferior olivary"),"Primary auditory",2,2378,1867,4245,0.000471142520612
"Interstitial nucleus",("Superior olive" OR "superior olivary"),7,507,1250,1757,0.00398406374502
Insula*,"Supplementary motor",255,16918,2106,19024,0.0134041211102
Hippocamp*,"Substantia nigra",2059,102035,17328,119363,0.0172499015608
("Locus coeruleus" OR "locus ceruleus"),("Ventral anterior" AND (nuclei OR nucleus)),6,7633,231,7864,0.000762970498474
"Lingual gyrus","Primary auditory",2,252,1867,2119,0.000943841434639
("Mammillary body" OR "Mammillary bodies),(Superior AND collicul*),48,1321,10036,11357,0.00422646825746
("Medial dorsal" AND nucl*),Pineal,0,113,14403,14516,0.0
"Lingual gyrus",Putamen,14,240,10735,10975,0.00127562642369
Orbitofrontal,Prefrontal,1279,1717,22822,24539,0.0521211133298
(Periventricular AND (nuclei OR nucleus)),Subgranular,0,2495,632,3127,0.0
Pineal,(Superior AND collicul*),55,14348,10029,24377,0.00225622513025
"Posterior parahippocampal gyrus",Suprachiasmatic,0,41,6026,6067,0.0
("Superior olive" OR "superior olivary"),("Ventral posterior" AND (nuclei OR nucleus)),2,1255,354,1609,0.00124300807955
Striatum,Suprachiasmatic,116,58824,5910,64734,0.00179194858961
("Straight gyrus" OR "gyrus rectus"),("Ventral posteromedial" AND (nuclei OR nucleus)),0,130,112,242,0.0
Suprachiasmatic,Thalamus,501,5525,42381,47906,0.0104579802112
"Posterior parietal",Subthalam*,8,2146,4121,6267,0.00127652784426
(Raphe AND (nuclei OR nucleus)),(Septal AND (nuclei OR nucleus)),317,8004,4343,12347,0.0256742528549
Ambiguus,Prefrontal,4,1212,24097,25309,0.000158046544707
"Broca's area","Wernicke's area",114,580,137,717,0.1589958159
"Anterior cingulate","Broca's area",37,5765,657,6422,0.0057614450327
Cerebellum,"Indusium griseum",6,65394,71,65465,9.16520278011e-05
"Diagonal band of Broca",("Posterior nucleus" AND hypothalamus),0,895,67,962,0.0
Cerebellum,"Lateral geniculate",129,65271,5051,70322,0.0018344188163
(Intralaminar AND (nuclei OR nucleus)),"Supplementary motor",5,1095,2356,3451,0.00144885540423
(Dorsomedial AND hypothal*),Subiculum,212,1927,98029,99956,0.00212093321061
(Dorsomedial AND hypothal*),"Substantia nigra",108,2031,19279,21310,0.00506804317222
Fusiform,"Posterior parahippocampal gyrus",1,5454,40,5494,0.000182016745541
"Calcarine fissure",Suprachiasmatic,0,103,6026,6129,0.0
("Centromedian" AND (nuclei OR nucleus)),(Cochlear AND (nuclei OR nucleus)),0,216,5307,5523,0.0
Hippocamp*,(Inferior AND collicul*),376,103718,3907,107625,0.00349361207898
Claustrum,"Dorsolateral prefrontal",342,82399,2662,85061,0.00402064400842
("Centromedian" AND (nuclei OR nucleus)),"Olfactory bulb",1,215,11210,11425,8.75273522976e-05
Cingulum,("Mammillary body" OR "Mammillary bodies),9,676,1360,2036,0.00442043222004
"Dentate gyrus","Olfactory bulb",440,11003,10771,21774,0.0202075870304
Entorhinal,Thalamus,377,5170,42505,47675,0.00790770844258
Hypothalam*,"Lingual gyrus",6,107543,248,107791,5.56632742993e-05
"Inferior frontal",Subthalam*,16,2796,4113,6909,0.002315819945
"Indusium griseum","Primary sensory",1,76,3009,3085,0.00032414910859
"Interstitial nucleus","Ventromedial prefrontal",0,514,3,517,0.0
"Lingual gyrus",(Periventricular AND (nuclei OR nucleus)),0,254,2495,2749,0.0
("Mammillary body" OR "Mammillary bodies),"Medial geniculate",22,22,1236,1258,0.0174880763116
("Medial dorsal" AND nucl*),Suprachiasmatic,1,112,6025,6137,0.000162946064853
("Mammillary body" OR "Mammillary bodies),("Superior olive" OR "superior olivary"),0,0,1255,1255,0.0
"Medial geniculate",Pons,92,1157,25492,26649,0.00345228714023
Parahippocamp*,(Septal AND (nuclei OR nucleus)),13,2646,0,2646,0.00491307634165
"Medial frontal",Prefrontal,404,1191,23697,24888,0.0162327225972
"Postcentral gyrus",Temporoparietal,5,526,1455,1981,0.002523977789
Orbitofrontal,("Ventral posterior" AND (nuclei OR nucleus)),0,2996,356,3352,0.0
("Posterior nucleus" AND hypothalamus),"Stria terminalis",4,63,2726,2789,0.00143420580853
(Periventricular AND (nuclei OR nucleus)),(Septal AND (nuclei OR nucleus)),211,2284,4449,6733,0.0313381850587
Pineal,"Primary auditory",0,14403,1869,16272,0.0
"Posterior parietal","Thalamic reticular",3,2151,597,2748,0.00109170305677
Striatum,("Ventral posterior" AND (nuclei OR nucleus)),21,58919,335,59254,0.000354406453573
"Thalamic reticular","Visual extrastriate",4,596,1530,2126,0.00188146754468
("Ventral anterior" AND (nuclei OR nucleus)),"Visual cortex",2,235,22878,23113,8.65313892615e-05
Pulvinar,("Ventral posteromedial" AND (nuclei OR nucleus)),4,1129,108,1237,0.00323362974939
Putamen,"Supplementary motor",174,10575,2187,12762,0.0136342266102
Infralimbic,Orbitofrontal,28,468,2968,3436,0.0081490104773
Ambiguus,Cerebellum,42,1174,65358,66532,0.000631275175855
"Basal forbrain",("Inferior olive" OR "Inferior olivary"),0,1,2380,2381,0.0
(Intralaminar AND (nuclei OR nucleus)),"Posterior cingulate",11,1089,1891,2980,0.00369127516779
(Dorsomedial AND hypothal*),"Nucleus basalis",8,2131,1839,3970,0.00201511335013
("Centromedian" AND (nuclei OR nucleus)),Prefrontal,6,210,24095,24305,0.000246862785435
(Dorsomedial AND hypothal*),Perirhinal,18,2121,1182,3303,0.00544959128065
"Lateral geniculate",Thalamus,4141,1039,38741,39780,0.10409753645
"Diagonal band of Broca",Temporoparietal,1,894,1459,2353,0.000424989375266
"Diagonal band of Broca",("Ventral posterolateral" AND (nuclei OR nucleus)),0,895,148,1043,0.0
Ambiguus,"Visual cortex",0,1216,22880,24096,0.0
"Lateral geniculate",(Superior AND collicul*),900,4280,9184,13464,0.0668449197861
"Basal forbrain","Ventral tegmentum",0,1,285,286,0.0
("Gustatory cortex" OR "gustatory area"),Operculum,18,135,908,1043,0.0172579098754
"Calcarine fissure","Piriform cortex",0,103,1743,1846,0.0
"Broca's area",Subthalam*,1,693,4128,4821,0.00020742584526
Caudate,"Indusium griseum",4,18797,73,18870,0.000211976682565
Hippocamp*,"Middle frontal",116,103978,912,104890,0.00110592048813
"Interstitial nucleus","Posterior cingulate",0,514,1902,2416,0.0
"Medial frontal",("Nucleus gracilis" OR "gracile nucleus"),0,1595,374,1969,0.0
("Medial dorsal" AND nucl*),"Visual cortex",4,109,22876,22985,0.000174026539047
("Nucleus gracilis" OR "gracile nucleus"),(Raphe AND (nuclei OR nucleus)),19,355,8302,8657,0.00219475568904
"Inferior frontal","Nucleus accumbens",11,2801,12534,15335,0.000717313335507
"Medial geniculate",("Ventral posteromedial" AND (nuclei OR nucleus)),5,1244,107,1351,0.00370096225019
Insula*,"Olfactory bulb",73,17100,11138,28238,0.00258516892131
(Medulla OR "medulla oblongata"),("Ventral anterior" AND (nuclei OR nucleus)),5,50817,232,51049,9.79451115595e-05
Operculum,"Pontine nuclei",2,924,796,1720,0.00116279069767
Operculum,("Straight gyrus" OR "gyrus rectus"),3,923,127,1050,0.00285714285714
"Nucleus basalis",periaqueductal,6,1841,4570,6411,0.000935891436593
"Middle temporal","Zona incerta",5,1632,969,2601,0.00192233756248
"Paracentral lobule","Posterior cingulate",9,56,1893,1949,0.00461775269369
"Paracentral lobule",("Ventral posterior" AND (nuclei OR nucleus)),0,65,356,421,0.0
"Primary auditory",("Straight gyrus" OR "gyrus rectus"),1,1868,129,1997,0.00050075112669
Precuneus,"Primary auditory",3,1217,1866,3083,0.000973078170613
"Superior frontal",("Ventral anterior" AND (nuclei OR nucleus)),0,1091,237,1328,0.0
"Superior temporal",("Ventral posterior" AND (nuclei OR nucleus)),0,4107,356,4463,0.0
Precuneus,"Thalamic reticular",0,1220,600,1820,0.0
("Red nucleus"),(Septal AND (nuclei OR nucleus)),32,2344,4628,6972,0.00458978772232
(Raphe AND (nuclei OR nucleus)),"Visual extrastriate",0,8321,1534,9855,0.0
"Amygdala",Pulvinar,76,23281,1057,24338,0.00312268879941
"Amygdala",Pons,753,22604,24831,47435,0.0158743543797
Ambiguus,"Posterior parahippocampal gyrus",0,1216,41,1257,0.0
"Anterior cingulate",Cerebellum,486,5316,64914,70230,0.00692011960701
("Centromedian" AND (nuclei OR nucleus)),(Raphe AND (nuclei OR nucleus)),14,202,8307,8509,0.00164531672347
"Calcarine fissure",Hippocamp*,2,101,104092,104193,1.91951474667e-05
"Lateral geniculate",Orbitofrontal,1,5179,2995,8174,0.000122339124052
"Diagonal band of Broca","Medial geniculate",2,893,1247,2140,0.000934579439252
Entorhinal,"Nucleus accumbens",202,5345,12343,17688,0.0114201718679
"Dorsolateral prefrontal","Substantia nigra",25,2979,19362,22341,0.00111901884428
"Calcarine fissure",Parahippocamp*,2,101,2657,2758,0.000725163161711
"Basal forbrain","Primary sensory",0,1,3010,3011,0.0
Caudate,"Nucleus accumbens",2322,16479,10223,26702,0.0869597782938
Claustrum,(Cochlear AND (nuclei OR nucleus)),77,82664,5230,87894,0.000876055248367
("Gustatory cortex" OR "gustatory area"),"Thalamic reticular",0,153,600,753,0.0
Claustrum,Putamen,6738,76003,4011,80014,0.0842102632039
Claustrum,"Stria terminalis",892,81849,1838,83687,0.0106587642047
Hypothalam*,(Raphe AND (nuclei OR nucleus)),1792,105757,6529,112286,0.015959246923
"Indusium griseum",Pineal,1,76,14402,14478,6.90703135792e-05
Entorhinal,"Superior frontal",14,5533,1077,6610,0.00211800302572
Hypothalam*,Infralimbic,122,107427,374,107801,0.00113171491916
"Dentate gyrus","Visual extrastriate",1,11442,1533,12975,7.70712909441e-05
(Inferior AND collicul*),"Inferior parietal lobule",14,4269,782,5051,0.00277172837062
Fusiform,("Straight gyrus" OR "gyrus rectus"),2,5453,128,5581,0.000358358717076
"Globus pallidus",Orbitofrontal,31,8075,2965,11040,0.00280797101449
"Inferior parietal lobule","Primary auditory",6,790,1863,2653,0.00226159065209
"Inferior temporal","Lingual gyrus",23,1688,231,1919,0.0119854090672
Hippocamp*,"Nucleus accumbens",1897,102197,10648,112845,0.0168106695024
"Interstitial nucleus","Medial frontal",0,514,1595,2109,0.0
"Medial geniculate","Thalamic reticular",31,1218,569,1787,0.0173475097929
"Inferior frontal",("Inferior olive" OR "Inferior olivary"),1,2811,2379,5190,0.00019267822736
("Locus coeruleus" OR "locus ceruleus"),Orbitofrontal,15,7624,2981,10605,0.001414427157
periaqueductal,Subiculum,357,4219,97884,102103,0.00349646925164
Insula*,Parahippocamp*,288,16885,2371,19256,0.0149563772331
"Olfactory bulb","Visual extrastriate",0,11211,1534,12745,0.0
Operculum,Pulvinar,8,918,1125,2043,0.00391581008321
("Locus coeruleus" OR "locus ceruleus"),Striatum,509,7130,58431,65561,0.00776376199265
"Olfactory bulb",Subiculum,2009,9202,96232,105434,0.0190545744257
"Medial frontal",Putamen,54,1541,10695,12236,0.00441320693037
"Nucleus accumbens","Primary sensory",6,12539,3004,15543,0.000386025863733
"Olfactory bulb",("Posterior nucleus" AND hypothalamus),2,11209,65,11274,0.000177399325883
"Paracentral lobule",Temporoparietal,0,65,1460,1525,0.0
Perirhinal,Subiculum,687,513,97554,98067,0.00700541466548
"Posterior parahippocampal gyrus","Primary sensory",0,41,3010,3051,0.0
"Posterior cingulate",Putamen,76,1826,10673,12499,0.00608048643892
Premotor,Prefrontal,973,3756,23128,26884,0.0361925308734
"Piriform cortex","Posterior cingulate",7,1736,1895,3631,0.00192784356926
"Piriform cortex","Primary auditory",0,1743,1869,3612,0.0
"Stria terminalis","Ventral tegmentum",8,2722,277,2999,0.00266755585195
(Septal AND (nuclei OR nucleus)),Thalamus,492,4168,42390,46558,0.0105674642382
Subiculum,Temporoparietal,72,98169,1388,99557,0.000723203792802
"Amygdala","Lateral geniculate",93,23264,5087,28351,0.00328030757293
Ambiguus,Entorhinal,6,1210,5541,6751,0.000888757221152
"Amygdala","Pontine nuclei",45,23312,753,24065,0.00186993559111
"Amygdala",("Red nucleus"),75,23282,2301,25583,0.00293163428839
Ambiguus,"Medial frontal",0,1216,1595,2811,0.0
Cerebellum,"Posterior cingulate",193,65207,1709,66916,0.00288421304322
Cerebellum,Pineal,361,65039,14042,79081,0.00456493974532
"Basal forbrain",(Intralaminar AND (nuclei OR nucleus)),0,1,1100,1101,0.0
"Dorsolateral prefrontal",Pons,21,2983,25563,28546,0.000735654732712
Entorhinal,("Nucleus cuneatus" OR "cuneate nucleus"),3,5544,689,6233,0.000481309160918
"Basal forbrain",Subgranular,0,1,632,633,0.0
Ambiguus,(Superior AND collicul*),31,1185,10053,11238,0.00275849795337
Ambiguus,"Wernicke's area",0,1216,251,1467,0.0
Caudate,("Nucleus gracilis" OR "gracile nucleus"),7,18794,367,19161,0.000365325400553
Cingulum,("Inferior olive" OR "Inferior olivary"),2,683,2378,3061,0.000653381247958
("Gustatory cortex" OR "gustatory area"),"Visual extrastriate",0,153,1534,1687,0.0
"Inferior frontal",Subgranular,0,2812,632,3444,0.0
(Inferior AND collicul*),"Inferior frontal",8,4275,2804,7079,0.00113010312191
("Heschl's gyrus" OR "Transverse temporal"),("Ventral posterolateral" AND (nuclei OR nucleus)),0,1148,148,1296,0.0
("Inferior olive" OR "Inferior olivary"),"Zona incerta",32,2348,942,3290,0.009726443769
"Inferior frontal","Wernicke's area",36,2776,215,2991,0.012036108325
Insula*,Subthalam*,42,17131,4087,21218,0.00197945140918
Hippocamp*,("Superior olive" OR "superior olivary"),58,104036,1199,105235,0.000551147431938
"Interstitial nucleus",Thalamus,73,441,42809,43250,0.00168786127168
Infralimbic,Parahippocamp*,9,487,2650,3137,0.00286898310488
Infralimbic,Putamen,21,475,10728,11203,0.00187449790235
"Nucleus basalis",Subthalam*,12,1835,4117,5952,0.00201612903226
("Nucleus cuneatus" OR "cuneate nucleus"),Premotor,1,691,4728,5419,0.000184535892231
periaqueductal,"Stria terminalis",222,4354,2508,6862,0.0323520839405
"Nucleus accumbens",("Ventral posterior" AND (nuclei OR nucleus)),7,12538,349,12887,0.000543183052689
"Postcentral gyrus","Supplementary motor",32,499,2329,2828,0.011315417256
"Paracentral lobule","Posterior parietal",3,62,2151,2213,0.00135562584727
"Medial frontal",("Ventral posterolateral" AND (nuclei OR nucleus)),0,1595,148,1743,0.0
"Posterior cingulate",Suprachiasmatic,0,1902,6026,7928,0.0
Perirhinal,Striatum,52,1148,58888,60036,0.00086614697848
"Posterior cingulate",("Superior olive" OR "superior olivary"),0,1902,1257,3159,0.0
Pineal,Striatum,166,14237,58774,73011,0.00227363000096
("Red nucleus"),("Ventral posteromedial" AND (nuclei OR nucleus)),1,2375,111,2486,0.000402252614642
"Piriform cortex","Stria terminalis",78,1665,2652,4317,0.0180681028492
(Septal AND (nuclei OR nucleus)),("Ventral anterior" AND (nuclei OR nucleus)),6,4654,231,4885,0.00122824974411
"Posterior parietal",Premotor,275,1879,4454,6333,0.0434233380704
"Superior frontal",Suprachiasmatic,0,1091,6026,7117,0.0
"Piriform cortex",("Ventral posterolateral" AND (nuclei OR nucleus)),0,1743,148,1891,0.0
"Medial geniculate","Middle temporal",2,1247,1635,2882,0.000693962526024
"Amygdala",Operculum,34,23323,892,24215,0.00140408837497
"Amygdala",Pineal,85,23272,14318,37590,0.00226123969141
"Angular gyrus",("Ventral posterolateral" AND (nuclei OR nucleus)),0,502,148,650,0.0
"Anterior cingulate",Parahippocamp*,242,5560,2417,7977,0.0303372195061
"Angular gyrus",Putamen,10,492,10739,11231,0.000890392663164
"Lateral geniculate","Nucleus accumbens",22,5158,12523,17681,0.00124427351394
"Anterior cingulate",Thalamus,944,4858,41938,46796,0.0201726643303
Cerebellum,"Inferior temporal",104,65296,1607,66903,0.00155448933531
"Dorsolateral prefrontal","Inferior temporal",41,2963,1670,4633,0.00884955752212
Entorhinal,"Paracentral lobule",0,5547,65,5612,0.0
Ambiguus,("Ventral posterior" AND (nuclei OR nucleus)),0,1216,356,1572,0.0
"Globus pallidus","Thalamic reticular",31,8075,569,8644,0.00358630263767
Entorhinal,"Interstitial nucleus",4,5543,510,6053,0.000660829340823
"Calcarine fissure","Posterior cingulate",1,102,1901,2003,0.000499251123315
Claustrum,("Inferior olive" OR "Inferior olivary"),114,82627,2266,84893,0.00134286690304
(Cochlear AND (nuclei OR nucleus)),(Medulla OR "medulla oblongata"),1020,4287,49802,54089,0.0188578084269
Claustrum,"Lingual gyrus",27,82714,227,82941,0.000325532607516
Hypothalam*,"Inferior temporal",24,107525,1687,109212,0.000219756070761
"Indusium griseum",("Ventral anterior" AND (nuclei OR nucleus)),0,77,237,314,0.0
Entorhinal,Suprachiasmatic,20,5527,6006,11533,0.00173415416631
("Inferior olive" OR "Inferior olivary"),Pineal,13,2367,14390,16757,0.00077579519007
"Globus pallidus",("Heschl's gyrus" OR "Transverse temporal"),2,8104,1146,9250,0.000216216216216
("Inferior olive" OR "Inferior olivary"),"Substantia nigra",176,2204,19211,21415,0.00821853840766
Hippocamp*,periaqueductal,371,103723,4205,107928,0.00343747683641
Hippocamp*,"Posterior parietal",141,103953,2013,105966,0.00133061548044
"Medial geniculate",Parahippocamp*,2,1247,2657,3904,0.000512295081967
("Nucleus gracilis" OR "gracile nucleus"),Striatum,7,367,58933,59300,0.000118043844857
"Medial geniculate",(Superior AND collicul*),228,1021,9856,10877,0.020961662223
Infralimbic,("Medial dorsal" AND nucl*),3,493,110,603,0.00497512437811
"Medial geniculate",Prefrontal,13,1236,24088,25324,0.000513347022587
"Middle frontal",Suprachiasmatic,0,1028,6026,7054,0.0
Pons,"Visual extrastriate",11,25573,1523,27096,0.000405963979923
Insula*,Infralimbic,109,17064,387,17451,0.00624606039768
Operculum,periaqueductal,6,920,4570,5490,0.00109289617486
"Postcentral gyrus",(Superior AND collicul*),1,530,10083,10613,9.42240648262e-05
"Medial frontal","Primary motor",17,1578,3188,4766,0.0035669324381
"Nucleus accumbens",Putamen,1837,10708,8912,19620,0.093628950051
Pons,"Posterior cingulate",33,25551,1869,27420,0.00120350109409
Operculum,"Supplementary motor",59,867,2302,3169,0.0186178605238
"Posterior cingulate","Posterior parietal",72,1830,2082,3912,0.0184049079755
"Middle temporal","Thalamic reticular",1,1636,599,2235,0.000447427293065
"Middle frontal",(Septal AND (nuclei OR nucleus)),0,1028,4660,5688,0.0
"Superior temporal","Ventral tegmentum",0,4107,285,4392,0.0
(Raphe AND (nuclei OR nucleus)),"Ventral tegmentum",34,8287,251,8538,0.00398219723589
("Red nucleus"),(Superior AND collicul*),172,2204,9912,12116,0.0141961043249
Infralimbic,Precuneus,0,496,1220,1716,0.0
"Amygdala",Parahippocamp*,492,22865,2167,25032,0.0196548418025
Ambiguus,(Raphe AND (nuclei OR nucleus)),102,1114,8219,9333,0.0109289617486
"Angular gyrus","Supplementary motor",19,483,2342,2825,0.00672566371681
"Calcarine fissure",Claustrum,1,102,82740,82842,1.20711716279e-05
"Anterior cingulate",periaqueductal,120,5682,4456,10138,0.0118366541724
("Centromedian" AND (nuclei OR nucleus)),("Ventral posterolateral" AND (nuclei OR nucleus)),4,212,144,356,0.0112359550562
"Calcarine fissure",Infralimbic,0,103,496,599,0.0
"Lateral geniculate",Temporoparietal,1,5179,1459,6638,0.000150647785478
Fusiform,Pineal,3,5452,14400,19852,0.000151118275237
"Diagonal band of Broca",("Ventral anterior" AND (nuclei OR nucleus)),1,894,236,1130,0.000884955752212
("Gustatory cortex" OR "gustatory area"),"Lateral geniculate",0,153,5180,5333,0.0
"Basal forbrain",Temporoparietal,0,1,1460,1461,0.0
("Gustatory cortex" OR "gustatory area"),Hypothalam*,20,133,107529,107662,0.000185766565733
"Broca's area",Pulvinar,0,694,1133,1827,0.0
("Heschl's gyrus" OR "Transverse temporal"),"Lateral geniculate",1,1147,5179,6326,0.000158077774265
("Gustatory cortex" OR "gustatory area"),Premotor,3,150,4726,4876,0.000615258408532
Hippocamp*,Hypothalam*,8946,95148,98603,193751,0.0461726649153
Hippocamp*,"Inferior frontal",199,103895,2613,106508,0.00186840425132
Cingulum,"Medial geniculate",1,684,1248,1932,0.000517598343685
("Gustatory cortex" OR "gustatory area"),Subthalam*,0,153,4129,4282,0.0
Claustrum,"Olfactory bulb",1186,81555,10025,91580,0.0129504258572
Hypothalam*,"Inferior parietal lobule",7,107542,789,108331,6.46167763613e-05
Hippocamp*,Perirhinal,719,103375,481,103856,0.00692304729626
Insula*,Temporoparietal,62,17111,1398,18509,0.00334972175698
Insula*,"Visual cortex",152,17021,22728,39749,0.00382399557222
Insula*,"Zona incerta",27,17146,947,18093,0.00149228983585
"Inferior temporal","Substantia nigra",14,1697,19373,21070,0.000664451827243
(Inferior AND collicul*),("Superior olive" OR "superior olivary"),425,3858,832,4690,0.090618336887
periaqueductal,"Posterior parietal",9,4567,2145,6712,0.00134088200238
periaqueductal,(Septal AND (nuclei OR nucleus)),154,4422,4506,8928,0.0172491039427
Perirhinal,"Postcentral gyrus",1,1199,530,1729,0.000578368999422
Perirhinal,"Primary auditory",12,1188,1857,3045,0.00394088669951
Insula*,Prefrontal,1391,15782,22710,38492,0.0361373791957
("Locus coeruleus" OR "locus ceruleus"),"Superior frontal",6,7633,1085,8718,0.000688231245699
Orbitofrontal,Subiculum,354,2642,97887,100529,0.00352137194242
Pons,Premotor,156,25428,4573,30001,0.00519982667244
("Posterior nucleus" AND hypothalamus),"Primary auditory",0,67,1869,1936,0.0
"Middle temporal","Stria terminalis",2,1635,2728,4363,0.00045840018336
(Septal AND (nuclei OR nucleus)),"Substantia nigra",288,4372,19099,23471,0.0122704614205
Pineal,("Ventral anterior" AND (nuclei OR nucleus)),0,14403,237,14640,0.0
"Piriform cortex",("Red nucleus"),22,1721,2354,4075,0.00539877300613
"Posterior parietal",(Superior AND collicul*),55,2099,10029,12128,0.00453496042216
Putamen,(Superior AND collicul*),214,10535,9870,20405,0.010487625582
Subgranular,("Ventral anterior" AND (nuclei OR nucleus)),0,632,237,869,0.0
"Anterior cingulate","Basal forbrain",0,5802,1,5803,0.0
"Anterior cingulate","Zona incerta",12,5790,962,6752,0.00177725118483
"Lateral geniculate","Ventromedial prefrontal",0,5180,3,5183,0.0
(Dorsomedial AND hypothal*),"Primary sensory",0,2139,3010,5149,0.0
"Dorsolateral prefrontal","Primary motor",73,2931,3132,6063,0.0120402441036
"Dorsolateral prefrontal",(Intralaminar AND (nuclei OR nucleus)),4,3000,1096,4096,0.0009765625
"Dorsolateral prefrontal",(Medulla OR "medulla oblongata"),2,3002,50820,53822,3.71595258445e-05
"Broca's area",("Heschl's gyrus" OR "Transverse temporal"),10,684,1138,1822,0.00548847420417
"Amygdala",Cingulum,42,23315,643,23958,0.00175306786877
"Basal forbrain",Pulvinar,0,1,1133,1134,0.0
"Calcarine fissure",periaqueductal,0,103,4576,4679,0.0
Entorhinal,"Primary motor",22,5525,3183,8708,0.00252641249426
("Gustatory cortex" OR "gustatory area"),("Medial dorsal" AND nucl*),0,153,113,266,0.0
("Heschl's gyrus" OR "Transverse temporal"),("Ventral posterior" AND (nuclei OR nucleus)),0,1148,356,1504,0.0
(Cochlear AND (nuclei OR nucleus)),"Dorsolateral prefrontal",0,5307,3004,8311,0.0
("Heschl's gyrus" OR "Transverse temporal"),Pons,11,1137,25573,26710,0.000411830774991
(Cochlear AND (nuclei OR nucleus)),"Primary sensory",15,5292,2995,8287,0.00181006395559
"Indusium griseum",Orbitofrontal,0,77,2996,3073,0.0
(Cochlear AND (nuclei OR nucleus)),"Posterior parietal",0,5307,2154,7461,0.0
"Inferior parietal lobule",Pineal,0,796,14403,15199,0.0
"Interstitial nucleus","Piriform cortex",3,511,1740,2251,0.001332741004
"Interstitial nucleus","Primary auditory",1,513,1868,2381,0.000419991600168
"Medial frontal",("Medial dorsal" AND nucl*),0,1595,113,1708,0.0
("Medial dorsal" AND nucl*),periaqueductal,4,109,4572,4681,0.000854518265328
"Inferior frontal",("Nucleus cuneatus" OR "cuneate nucleus"),0,2812,692,3504,0.0
("Nucleus gracilis" OR "gracile nucleus"),Prefrontal,2,372,24099,24471,8.17293939765e-05
("Medial dorsal" AND nucl*),(Raphe AND (nuclei OR nucleus)),5,108,8316,8424,0.000593542260209
("Nucleus gracilis" OR "gracile nucleus"),(Septal AND (nuclei OR nucleus)),4,370,4656,5026,0.000795861520096
"Inferior frontal",Pons,19,2793,25565,28358,0.000670004936878
("Nucleus cuneatus" OR "cuneate nucleus"),(Raphe AND (nuclei OR nucleus)),47,645,8274,8919,0.0052696490638
Parahippocamp*,Subiculum,1441,1218,96800,98018,0.0147013813789
Insula*,("Nucleus cuneatus" OR "cuneate nucleus"),6,17167,686,17853,0.000336077970089
"Pontine nuclei",("Red nucleus"),69,729,2307,3036,0.0227272727273
Operculum,"Olfactory bulb",1,925,11210,12135,8.2406262876e-05
"Olfactory bulb","Primary motor",0,11211,3205,14416,0.0
"Nucleus basalis",("Nucleus gracilis" OR "gracile nucleus"),0,1847,374,2221,0.0
"Medial frontal",("Ventral anterior" AND (nuclei OR nucleus)),2,1593,235,1828,0.00109409190372
(Medulla OR "medulla oblongata"),"Ventromedial prefrontal",0,50822,3,50825,0.0
(Periventricular AND (nuclei OR nucleus)),"Superior temporal",2,2493,4105,6598,0.00030312215823
("Red nucleus"),"Zona incerta",45,2331,929,3260,0.0138036809816
Striatum,"Stria terminalis",238,58702,2492,61194,0.00388927018989
Pulvinar,"Primary motor",8,1125,3197,4322,0.00185099490976
(Superior AND collicul*),("Ventral posterolateral" AND (nuclei OR nucleus)),6,10078,142,10220,0.000587084148728
Pulvinar,("Straight gyrus" OR "gyrus rectus"),1,1132,129,1261,0.000793021411578
Subgranular,"Zona incerta",1,631,973,1604,0.000623441396509
"Amygdala","Lingual gyrus",18,23339,236,23575,0.000763520678685
"Angular gyrus",Subthalam*,1,501,4128,4629,0.000216029379996
"Anterior cingulate","Lateral geniculate",4,5798,5176,10974,0.000364497904137
"Calcarine fissure",Entorhinal,0,103,5547,5650,0.0
"Dorsolateral prefrontal",("Ventral posterior" AND (nuclei OR nucleus)),1,3003,355,3358,0.000297796307326
(Dorsomedial AND hypothal*),(Raphe AND (nuclei OR nucleus)),212,1927,8109,10036,0.0211239537664
"Dorsolateral prefrontal",Subgranular,0,3004,632,3636,0.0
("Centromedian" AND (nuclei OR nucleus)),"Dorsolateral prefrontal",1,215,3003,3218,0.000310752019888
"Calcarine fissure","Stria terminalis",0,103,2730,2833,0.0
Cingulum,Striatum,25,660,58915,59575,0.000419639110365
Claustrum,Pulvinar,154,82587,979,83566,0.00184285474954
"Indusium griseum",("Mammillary body" OR "Mammillary bodies),1,76,1,77,0.012987012987
Hypothalam*,"Supplementary motor",15,107534,2346,109880,0.000136512559155
Hypothalam*,Subthalam*,308,107241,3821,111062,0.00277322576579
("Mammillary body" OR "Mammillary bodies),("Medial dorsal" AND nucl*),85,85,110,195,0.435897435897
("Mammillary body" OR "Mammillary bodies),"Primary auditory",1,1,1868,1869,0.000535045478866
("Mammillary body" OR "Mammillary bodies),("Straight gyrus" OR "gyrus rectus"),0,0,130,130,0.0
"Inferior temporal","Zona incerta",0,1711,974,2685,0.0
Infralimbic,Premotor,5,491,4724,5215,0.000958772770853
Infralimbic,Subthalam*,10,486,4119,4605,0.00217155266015
Infralimbic,Subgranular,0,496,632,1128,0.0
"Postcentral gyrus","Posterior parietal",19,512,2135,2647,0.0071779372875
"Medial frontal",("Ventral posterior" AND (nuclei OR nucleus)),0,1595,356,1951,0.0
(Periventricular AND (nuclei OR nucleus)),"Substantia nigra",142,2353,19245,21598,0.006574682841
Pineal,"Substantia nigra",58,14345,19329,33674,0.00172239710162
"Primary motor","Substantia nigra",39,3166,19348,22514,0.00173225548548
(Septal AND (nuclei OR nucleus)),"Thalamic reticular",11,4649,589,5238,0.00210003818251
"Piriform cortex",Subgranular,5,1738,627,2365,0.00211416490486
"Superior frontal",Thalamus,105,986,42777,43763,0.00239928706899
Precuneus,Striatum,53,1167,58887,60054,0.00088253904819
("Red nucleus"),"Stria terminalis",19,2357,2711,5068,0.00374901341752
("Ventral posteromedial" AND (nuclei OR nucleus)),"Ventral tegmentum",0,112,285,397,0.0
periaqueductal,"Superior temporal",14,4562,4093,8655,0.00161756210283
Precuneus,"Zona incerta",0,1220,974,2194,0.0
Ambiguus,"Postcentral gyrus",0,1216,531,1747,0.0
"Basal forbrain",Fusiform,0,1,5455,5456,0.0
"Angular gyrus","Interstitial nucleus",0,502,514,1016,0.0
"Broca's area","Indusium griseum",0,694,77,771,0.0
"Broca's area",Subiculum,31,663,98210,98873,0.000313533522802
Caudate,Infralimbic,30,18771,466,19237,0.00155949472371
Caudate,"Lingual gyrus",28,18773,226,18999,0.00147376177694
("Heschl's gyrus" OR "Transverse temporal"),"Wernicke's area",4,1144,247,1391,0.00287562904385
("Heschl's gyrus" OR "Transverse temporal"),("Gustatory cortex" OR "gustatory area"),0,1148,153,1301,0.0
Cingulum,(Inferior AND collicul*),2,683,4281,4964,0.000402900886382
"Dentate gyrus",Striatum,587,10856,58353,69209,0.00848155586701
Fusiform,Insula*,159,5296,17014,22310,0.00712684894666
"Indusium griseum",Perirhinal,0,77,1200,1277,0.0
Fusiform,"Substantia nigra",39,5416,19348,24764,0.00157486674204
"Inferior frontal",("Superior olive" OR "superior olivary"),0,2812,1257,4069,0.0
("Locus coeruleus" OR "locus ceruleus"),"Visual extrastriate",1,7638,1533,9171,0.00010903936321
("Mammillary body" OR "Mammillary bodies),("Nucleus cuneatus" OR "cuneate nucleus"),0,0,692,692,0.0
"Inferior temporal",Parahippocamp*,143,1568,2516,4084,0.0350146914789
"Globus pallidus","Pontine nuclei",36,8070,762,8832,0.00407608695652
(Inferior AND collicul*),Subgranular,0,4283,632,4915,0.0
"Lingual gyrus",("Red nucleus"),0,254,2376,2630,0.0
(Medulla OR "medulla oblongata"),Temporoparietal,3,50819,1457,52276,5.73877113781e-05
Insula*,Pons,169,17004,25415,42419,0.00398406374502
("Locus coeruleus" OR "locus ceruleus"),("Red nucleus"),103,7536,2273,9809,0.0105005607096
Operculum,"Stria terminalis",0,926,2730,3656,0.0
"Postcentral gyrus","Visual extrastriate",0,531,1534,2065,0.0
"Paracentral lobule",("Red nucleus"),0,65,2376,2441,0.0
"Posterior cingulate",Pulvinar,16,1886,1117,3003,0.00532800532801
("Straight gyrus" OR "gyrus rectus"),("Ventral posterior" AND (nuclei OR nucleus)),0,130,356,486,0.0
(Periventricular AND (nuclei OR nucleus)),"Zona incerta",124,2371,850,3221,0.038497361068
("Straight gyrus" OR "gyrus rectus"),"Visual extrastriate",0,130,1534,1664,0.0
(Septal AND (nuclei OR nucleus)),Subiculum,1500,3160,96741,99901,0.0150148647161
Temporoparietal,("Ventral anterior" AND (nuclei OR nucleus)),0,1460,237,1697,0.0
Pulvinar,("Red nucleus"),7,1126,2369,3495,0.00200286123033
Pulvinar,"Superior temporal",46,1087,4061,5148,0.00893550893551
Striatum,("Ventral posterolateral" AND (nuclei OR nucleus)),11,58929,137,59066,0.000186232350252
("Nucleus gracilis" OR "gracile nucleus"),("Superior olive" OR "superior olivary"),6,368,1251,1619,0.00370599135269
Subgranular,"Wernicke's area",0,632,251,883,0.0
Ambiguus,("Heschl's gyrus" OR "Transverse temporal"),0,1216,1148,2364,0.0
"Amygdala",(Raphe AND (nuclei OR nucleus)),680,22677,7641,30318,0.0224289201135
"Amygdala","Visual cortex",245,23112,22635,45747,0.00535554243994
"Angular gyrus",("Posterior nucleus" AND hypothalamus),0,502,67,569,0.0
"Lateral geniculate","Primary sensory",20,5160,2990,8150,0.00245398773006
Cerebellum,Hippocamp*,8991,56409,95103,151512,0.0593418343102
"Lateral geniculate","Posterior parahippocampal gyrus",1,5179,40,5219,0.00019160758766
Cerebellum,"Interstitial nucleus",86,65314,428,65742,0.00130814395668
(Dorsomedial AND hypothal*),"Superior frontal",0,2139,1091,3230,0.0
Fusiform,Parahippocamp*,301,5154,2358,7512,0.0400692225772
"Dorsolateral prefrontal","Medial frontal",93,2911,1502,4413,0.0210740992522
("Gustatory cortex" OR "gustatory area"),Infralimbic,2,151,494,645,0.0031007751938
Entorhinal,Hippocamp*,4186,1361,99908,101269,0.0413354531002
("Heschl's gyrus" OR "Transverse temporal"),("Red nucleus"),2,1146,2374,3520,0.000568181818182
("Heschl's gyrus" OR "Transverse temporal"),Orbitofrontal,10,1138,2986,4124,0.00242483026188
("Gustatory cortex" OR "gustatory area"),"Stria terminalis",8,145,2722,2867,0.00279037321242
Claustrum,(Superior AND collicul*),620,82121,9464,91585,0.00676966752197
(Cochlear AND (nuclei OR nucleus)),"Nucleus accumbens",16,5291,12529,17820,0.000897867564534
Claustrum,(Septal AND (nuclei OR nucleus)),1560,81181,3100,84281,0.0185095098539
"Dentate gyrus","Medial frontal",8,11435,1587,13022,0.000614344954692
("Inferior olive" OR "Inferior olivary"),Putamen,75,2305,10674,12979,0.00577856537484
"Inferior temporal","Middle temporal",141,1570,1496,3066,0.045988258317
"Interstitial nucleus",Pineal,4,510,14399,14909,0.000268294318868
("Mammillary body" OR "Mammillary bodies),"Nucleus accumbens",46,46,12503,12549,0.00366563072755
Hippocamp*,"Visual extrastriate",32,104062,1502,105564,0.000303133644045
"Inferior parietal lobule","Supplementary motor",61,735,2300,3035,0.0200988467875
("Locus coeruleus" OR "locus ceruleus"),Operculum,3,7636,923,8559,0.000350508236944
("Medial dorsal" AND nucl*),(Medulla OR "medulla oblongata"),8,105,50814,50919,0.00015711227636
("Medial dorsal" AND nucl*),Prefrontal,15,98,24086,24184,0.000620244789944
"Inferior temporal",("Ventral posteromedial" AND (nuclei OR nucleus)),0,1711,112,1823,0.0
("Nucleus cuneatus" OR "cuneate nucleus"),"Superior temporal",0,692,4107,4799,0.0
"Medial geniculate",Premotor,5,1244,4724,5968,0.000837801608579
"Pontine nuclei","Primary motor",9,789,3196,3985,0.00225846925972
("Locus coeruleus" OR "locus ceruleus"),"Postcentral gyrus",3,7636,528,8164,0.000367466927976
"Postcentral gyrus","Posterior cingulate",23,508,1879,2387,0.00963552576456
"Nucleus accumbens",Thalamus,785,11760,42097,53857,0.0145756354791
"Paracentral lobule",(Septal AND (nuclei OR nucleus)),0,65,4660,4725,0.0
Orbitofrontal,Thalamus,349,2647,42533,45180,0.00772465692784
"Posterior cingulate","Primary sensory",14,1888,2996,4884,0.0028665028665
"Stria terminalis",Striatum,238,2492,58702,61194,0.00388927018989
"Piriform cortex",("Superior olive" OR "superior olivary"),6,1737,1251,2988,0.00200803212851
Prefrontal,(Septal AND (nuclei OR nucleus)),126,23975,4534,28509,0.00441965695044
"Superior temporal",("Ventral posteromedial" AND (nuclei OR nucleus)),1,4106,111,4217,0.000237135404316
"Amygdala","Indusium griseum",11,23346,66,23412,0.000469844524176
"Amygdala",Thalamus,2982,20375,39900,60275,0.0494732476151
"Angular gyrus","Piriform cortex",0,502,1743,2245,0.0
(Intralaminar AND (nuclei OR nucleus)),Prefrontal,83,1017,24018,25035,0.0033153584981
Cingulate,Cerebellum,1033,10071,64367,74438,0.0138773207233
"Anterior cingulate","Diagonal band of Broca",14,5788,881,6669,0.00209926525716
"Basal forbrain","Inferior temporal",0,1,1711,1712,0.0
Cerebellum,(Raphe AND (nuclei OR nucleus)),452,64948,7869,72817,0.00620734169219
"Dorsolateral prefrontal","Visual cortex",70,2934,22810,25744,0.00271908017402
(Dorsomedial AND hypothal*),"Piriform cortex",33,2106,1710,3816,0.00864779874214
(Dorsomedial AND hypothal*),"Olfactory bulb",50,2089,11161,13250,0.00377358490566
(Dorsomedial AND hypothal*),Thalamus,329,1810,42553,44363,0.0074160899849
"Lateral geniculate","Ventral tegmentum",1,5179,284,5463,0.000183049606443
"Dorsolateral prefrontal","Middle temporal",47,2957,1590,4547,0.0103364855949
Entorhinal,(Dorsomedial AND hypothal*),36,5511,2103,7614,0.00472813238771
"Calcarine fissure","Nucleus basalis",0,103,1847,1950,0.0
"Broca's area","Medial geniculate",0,694,1249,1943,0.0
Cingulum,"Inferior temporal",11,674,1700,2374,0.00463352990733
Caudate,"Wernicke's area",2,18799,249,19048,0.000104997900042
Claustrum,"Inferior temporal",110,82631,1601,84232,0.00130591699117
Hypothalam*,Pulvinar,58,107491,1075,108566,0.000534237238178
"Dentate gyrus",("Ventral anterior" AND (nuclei OR nucleus)),0,11443,237,11680,0.0
("Inferior olive" OR "Inferior olivary"),"Middle temporal",1,2379,1636,4015,0.000249066002491
(Inferior AND collicul*),Perirhinal,18,4265,1182,5447,0.00330457132366
"Globus pallidus",Hypothalam*,690,7416,106859,114275,0.00603806606869
"Inferior parietal lobule",Subgranular,0,796,632,1428,0.0
Entorhinal,Subthalam*,20,5527,4109,9636,0.00207555002076
"Lingual gyrus",Orbitofrontal,20,234,2976,3210,0.00623052959502
"Lingual gyrus","Wernicke's area",0,254,251,505,0.0
("Nucleus gracilis" OR "gracile nucleus"),Orbitofrontal,0,374,2996,3370,0.0
("Nucleus cuneatus" OR "cuneate nucleus"),(Septal AND (nuclei OR nucleus)),5,687,4655,5342,0.00093597903407
("Nucleus gracilis" OR "gracile nucleus"),"Superior frontal",0,374,1091,1465,0.0
Infralimbic,"Posterior parietal",2,494,2152,2646,0.000755857898715
Operculum,Thalamus,69,857,42813,43670,0.00158003205862
"Nucleus accumbens",("Ventral anterior" AND (nuclei OR nucleus)),15,12530,222,12752,0.00117628607277
Orbitofrontal,Precuneus,67,2929,1153,4082,0.0164135227829
"Medial frontal","Ventral tegmentum",1,1594,284,1878,0.000532481363152
("Posterior nucleus" AND hypothalamus),"Visual extrastriate",0,67,1534,1601,0.0
"Posterior cingulate",Prefrontal,620,1282,23481,24763,0.025037354117
Premotor,Thalamus,440,4289,42442,46731,0.00941559136333
"Middle frontal",Prefrontal,315,713,23786,24499,0.0128576676599
"Thalamic reticular","Wernicke's area",0,600,251,851,0.0
(Superior AND collicul*),("Ventral posterior" AND (nuclei OR nucleus)),17,10067,339,10406,0.00163367288103
"Substantia nigra",Thalamus,2104,17283,40778,58061,0.0362377499526
"Amygdala","Primary sensory",32,23325,2978,26303,0.00121659126335
"Amygdala",(Periventricular AND (nuclei OR nucleus)),305,23052,2190,25242,0.0120830362095
"Anterior cingulate",Precuneus,270,5532,950,6482,0.0416538105523
"Anterior cingulate",Pulvinar,29,5773,1104,6877,0.00421695506762
"Anterior cingulate",("Red nucleus"),6,5796,2370,8166,0.000734753857458
"Angular gyrus","Zona incerta",0,502,974,1476,0.0
"Lateral geniculate",Subiculum,190,4990,98051,103041,0.00184392620413
"Diagonal band of Broca",("Ventral posteromedial" AND (nuclei OR nucleus)),1,894,111,1005,0.000995024875622
"Dentate gyrus",(Cochlear AND (nuclei OR nucleus)),31,11412,5276,16688,0.00185762224353
"Dentate gyrus","Diagonal band of Broca",38,11405,857,12262,0.00309900505627
"Broca's area",("Straight gyrus" OR "gyrus rectus"),0,694,130,824,0.0
"Calcarine fissure",Thalamus,10,93,42872,42965,0.000232747585244
Claustrum,"Visual cortex",611,82130,22269,104399,0.00585254648033
"Indusium griseum",("Locus coeruleus" OR "locus ceruleus"),3,74,7636,7710,0.000389105058366
Hypothalam*,("Ventral posteromedial" AND (nuclei OR nucleus)),11,107538,101,107639,0.000102193442897
"Globus pallidus","Medial geniculate",27,8079,1222,9301,0.0029029136652
"Inferior parietal lobule",("Superior olive" OR "superior olivary"),1,795,1256,2051,0.000487567040468
Hippocamp*,"Primary sensory",78,104016,2932,106948,0.000729326401616
Hippocamp*,Precuneus,182,103912,1038,104950,0.00173415912339
("Mammillary body" OR "Mammillary bodies),(Medulla OR "medulla oblongata"),30,30,50783,50813,0.000590400094464
("Nucleus gracilis" OR "gracile nucleus"),"Pontine nuclei",7,367,791,1158,0.00604490500864
("Medial dorsal" AND nucl*),"Posterior parietal",2,111,2152,2263,0.000883782589483
("Nucleus cuneatus" OR "cuneate nucleus"),Precuneus,0,692,1220,1912,0.0
periaqueductal,"Visual extrastriate",0,4576,1534,6110,0.0
"Middle frontal",("Ventral posterolateral" AND (nuclei OR nucleus)),0,1028,148,1176,0.0
Perirhinal,("Red nucleus"),3,1197,2373,3570,0.000840336134454
(Medulla OR "medulla oblongata"),"Primary motor",22,50800,3183,53983,0.000407535705685
("Locus coeruleus" OR "locus ceruleus"),"Primary auditory",4,7635,1865,9500,0.000421052631579
"Nucleus accumbens","Olfactory bulb",407,12138,10804,22942,0.0177403888066
"Olfactory bulb",("Superior olive" OR "superior olivary"),22,11189,1235,12424,0.00177076625885
"Medial frontal",(Septal AND (nuclei OR nucleus)),14,1581,4646,6227,0.00224827364702
"Medial frontal",Subthalam*,4,1591,4125,5716,0.000699790062981
Operculum,(Superior AND collicul*),5,921,10079,11000,0.000454545454545
"Paracentral lobule",Subgranular,0,65,632,697,0.0
Orbitofrontal,("Ventral posteromedial" AND (nuclei OR nucleus)),0,2996,112,3108,0.0
("Posterior nucleus" AND hypothalamus),"Zona incerta",6,61,968,1029,0.00583090379009
("Posterior nucleus" AND hypothalamus),"Superior temporal",0,67,4107,4174,0.0
"Posterior parahippocampal gyrus",Thalamus,3,38,42879,42917,6.99023696903e-05
"Posterior parahippocampal gyrus",("Ventral posteromedial" AND (nuclei OR nucleus)),0,41,112,153,0.0
"Posterior parietal",("Superior olive" OR "superior olivary"),0,2154,1257,3411,0.0
Prefrontal,("Superior olive" OR "superior olivary"),3,24098,1254,25352,0.000118333859262
(Raphe AND (nuclei OR nucleus)),("Ventral posterior" AND (nuclei OR nucleus)),14,8307,342,8649,0.00161868424095
"Anterior cingulate",Perirhinal,44,5758,1156,6914,0.00636389933468
Cerebellum,Insula*,576,64824,16597,81421,0.00707434200022
"Dorsolateral prefrontal","Diagonal band of Broca",0,3004,895,3899,0.0
(Dorsomedial AND hypothal*),(Septal AND (nuclei OR nucleus)),158,1981,4502,6483,0.0243714329786
"Diagonal band of Broca",Subiculum,298,597,97943,98540,0.00302415262837
(Dorsomedial AND hypothal*),Subgranular,0,2139,632,2771,0.0
Entorhinal,Operculum,5,5542,921,6463,0.000773634535046
(Intralaminar AND (nuclei OR nucleus)),("Ventral anterior" AND (nuclei OR nucleus)),45,1055,192,1247,0.0360866078589
("Gustatory cortex" OR "gustatory area"),("Locus coeruleus" OR "locus ceruleus"),1,152,7638,7790,0.00012836970475
("Centromedian" AND (nuclei OR nucleus)),Operculum,0,216,926,1142,0.0
(Cochlear AND (nuclei OR nucleus)),(Dorsomedial AND hypothal*),9,5298,2130,7428,0.00121163166397
"Inferior frontal","Substantia nigra",9,2803,19378,22181,0.000405752671205
"Globus pallidus","Piriform cortex",41,8065,1702,9767,0.0041978089485
"Inferior parietal lobule","Medial frontal",40,756,1555,2311,0.0173085244483
"Lingual gyrus","Postcentral gyrus",12,242,519,761,0.0157687253614
"Interstitial nucleus",Orbitofrontal,0,514,2996,3510,0.0
"Inferior temporal","Ventral tegmentum",0,1711,285,1996,0.0
"Medial geniculate",("Ventral anterior" AND (nuclei OR nucleus)),5,1244,232,1476,0.00338753387534
Insula*,"Interstitial nucleus",5,17168,509,17677,0.000282853425355
Insula*,"Posterior cingulate",314,16859,1588,18447,0.017021737952
Insula*,"Primary auditory",39,17134,1830,18964,0.00205652815862
Operculum,Striatum,27,899,58913,59812,0.000451414431887
Orbitofrontal,Subgranular,1,2995,631,3626,0.000275785990072
(Periventricular AND (nuclei OR nucleus)),(Raphe AND (nuclei OR nucleus)),228,2267,8093,10360,0.0220077220077
"Posterior parahippocampal gyrus",Striatum,1,40,58939,58979,1.69551874396e-05
(Periventricular AND (nuclei OR nucleus)),Pons,148,2347,25436,27783,0.00532699852428
Premotor,"Ventral tegmentum",1,4728,284,5012,0.000199521149242
Premotor,Subiculum,106,4623,98135,102758,0.001031549855
Precuneus,(Raphe AND (nuclei OR nucleus)),1,1219,8320,9539,0.000104832791697
Prefrontal,Thalamus,1852,22249,41030,63279,0.0292672134515
(Raphe AND (nuclei OR nucleus)),("Ventral posteromedial" AND (nuclei OR nucleus)),4,8317,108,8425,0.000474777448071
Ambiguus,periaqueductal,52,1164,4524,5688,0.00914205344585
"Angular gyrus","Dentate gyrus",3,499,11440,11939,0.000251277326409
"Anterior cingulate",("Mammillary body" OR "Mammillary bodies),15,5787,41,5828,0.00257378174331
"Angular gyrus",Prefrontal,94,408,24007,24415,0.00385009215646
("Centromedian" AND (nuclei OR nucleus)),"Substantia nigra",30,186,19357,19543,0.00153507649798
"Diagonal band of Broca",("Locus coeruleus" OR "locus ceruleus"),55,840,7584,8424,0.0065289648623
"Amygdala","Anterior cingulate",899,22458,4903,27361,0.0328569862213
"Globus pallidus",("Ventral anterior" AND (nuclei OR nucleus)),50,8056,187,8243,0.00606575275992
"Calcarine fissure","Ventral tegmentum",0,103,285,388,0.0
Claustrum,Striatum,44821,37920,14119,52039,0.861296335441
(Cochlear AND (nuclei OR nucleus)),"Globus pallidus",24,5283,8082,13365,0.00179573512907
"Indusium griseum",("Straight gyrus" OR "gyrus rectus"),0,77,130,207,0.0
Hypothalam*,("Superior olive" OR "superior olivary"),58,107491,1199,108690,0.000533627748643
"Dentate gyrus",Suprachiasmatic,67,11376,5959,17335,0.00386501297952
"Dentate gyrus",("Inferior olive" OR "Inferior olivary"),41,11402,2339,13741,0.00298377119569
"Globus pallidus",Insula*,108,7998,17065,25063,0.00430914096477
("Inferior olive" OR "Inferior olivary"),Orbitofrontal,1,2379,2995,5374,0.000186081131373
"Inferior frontal","Visual extrastriate",42,2770,1492,4262,0.00985452839043
"Inferior parietal lobule","Inferior temporal",48,748,1663,2411,0.0199087515554
"Interstitial nucleus",Suprachiasmatic,8,506,6018,6524,0.00122624156959
Hippocamp*,(Superior AND collicul*),596,103498,9488,112986,0.00527498982175
Infralimbic,(Intralaminar AND (nuclei OR nucleus)),10,486,1090,1576,0.00634517766497
"Inferior frontal",Perirhinal,5,2807,1195,4002,0.00124937531234
Infralimbic,"Primary sensory",4,492,3006,3498,0.00114351057747
"Nucleus basalis","Substantia nigra",144,1703,19243,20946,0.0068748209682
Parahippocamp*,"Substantia nigra",49,2610,19338,21948,0.00223254966284
Operculum,"Zona incerta",2,924,972,1896,0.00105485232068
"Postcentral gyrus",Suprachiasmatic,0,531,6026,6557,0.0
"Postcentral gyrus","Ventral tegmentum",0,531,285,816,0.0
("Posterior nucleus" AND hypothalamus),Premotor,0,67,4729,4796,0.0
"Primary auditory",("Ventral posteromedial" AND (nuclei OR nucleus)),0,1869,112,1981,0.0
("Straight gyrus" OR "gyrus rectus"),Subgranular,0,130,632,762,0.0
Premotor,"Zona incerta",13,4716,961,5677,0.00228994187071
"Middle frontal","Primary motor",15,1013,3190,4203,0.00356887937188
Pineal,"Wernicke's area",0,14403,251,14654,0.0
"Supplementary motor",("Ventral posterior" AND (nuclei OR nucleus)),4,2357,352,2709,0.00147655961609
(Superior AND collicul*),Suprachiasmatic,142,9942,5884,15826,0.0089725767724
("Ventral posteromedial" AND (nuclei OR nucleus)),"Wernicke's area",0,112,251,363,0.0
Prefrontal,Precuneus,449,23652,771,24423,0.0183843098718
(Raphe AND (nuclei OR nucleus)),Putamen,231,8090,10518,18608,0.0124140154772
"Substantia nigra",("Ventral posterolateral" AND (nuclei OR nucleus)),5,19382,143,19525,0.000256081946223
Putamen,"Wernicke's area",2,10747,249,10996,0.000181884321571
Ambiguus,Cingulate,8,1208,11096,12304,0.000650195058518
"Amygdala","Middle frontal",59,23298,969,24267,0.00243128528454
"Angular gyrus",Subgranular,0,502,632,1134,0.0
"Anterior cingulate",Pons,85,5717,25499,31216,0.00272296258329
Ambiguus,("Straight gyrus" OR "gyrus rectus"),1,1215,129,1344,0.000744047619048
"Anterior cingulate","Superior frontal",187,5615,904,6519,0.0286853811934
"Angular gyrus",(Inferior AND collicul*),2,500,4281,4781,0.000418322526668
Cingulate,(Periventricular AND (nuclei OR nucleus)),50,11054,2445,13499,0.00370397807245
"Diagonal band of Broca","Visual extrastriate",1,894,1533,2427,0.00041203131438
"Lateral geniculate",Striatum,88,5092,58852,63944,0.00137620417866
"Calcarine fissure","Olfactory bulb",0,103,11211,11314,0.0
("Heschl's gyrus" OR "Transverse temporal"),"Interstitial nucleus",0,1148,514,1662,0.0
"Basal forbrain","Pontine nuclei",0,1,798,799,0.0
("Heschl's gyrus" OR "Transverse temporal"),"Superior frontal",9,1139,1082,2221,0.0040522287258
("Heschl's gyrus" OR "Transverse temporal"),"Middle temporal",21,1127,1616,2743,0.00765585125775
Cingulate,Subiculum,1985,9119,96256,105375,0.018837485172
(Cochlear AND (nuclei OR nucleus)),(Intralaminar AND (nuclei OR nucleus)),6,5301,1094,6395,0.000938232994527
Cingulum,"Stria terminalis",15,670,2715,3385,0.00443131462334
Cingulum,("Posterior nucleus" AND hypothalamus),0,685,67,752,0.0
("Inferior olive" OR "Inferior olivary"),Suprachiasmatic,22,2358,6004,8362,0.0026309495336
"Dentate gyrus",("Ventral posteromedial" AND (nuclei OR nucleus)),3,11440,109,11549,0.000259762750022
("Inferior olive" OR "Inferior olivary"),("Mammillary body" OR "Mammillary bodies),14,2366,1,2367,0.00591465990706
("Inferior olive" OR "Inferior olivary"),("Ventral posteromedial" AND (nuclei OR nucleus)),2,2378,110,2488,0.0008038585209
"Inferior temporal",Perirhinal,46,1665,1154,2819,0.0163178432068
("Medial dorsal" AND nucl*),"Nucleus basalis",3,110,1844,1954,0.00153531218014
("Locus coeruleus" OR "locus ceruleus"),"Nucleus basalis",124,7515,1723,9238,0.0134228187919
("Mammillary body" OR "Mammillary bodies),Temporoparietal,2,1367,1458,2825,0.00070796460177
("Medial dorsal" AND nucl*),"Ventral tegmentum",1,112,284,396,0.00252525252525
Parahippocamp*,"Zona incerta",2,2657,972,3629,0.00055111600992
"Inferior temporal","Wernicke's area",12,1699,239,1938,0.0061919504644
"Inferior frontal",(Inferior AND collicul*),8,2804,4275,7079,0.00113010312191
periaqueductal,"Primary sensory",12,4564,2998,7562,0.00158688177731
("Mammillary body" OR "Mammillary bodies),Pineal,19,1350,14384,15734,0.00120757595017
Pons,("Ventral posterolateral" AND (nuclei OR nucleus)),14,25570,134,25704,0.000544662309368
Insula*,periaqueductal,149,17024,4427,21451,0.0069460631206
"Olfactory bulb","Wernicke's area",0,11211,251,11462,0.0
(Periventricular AND (nuclei OR nucleus)),"Visual cortex",6,2489,22874,25363,0.000236565075109
"Posterior parahippocampal gyrus","Visual extrastriate",2,39,1532,1571,0.00127307447486
Striatum,"Ventral tegmentum",63,58877,222,59099,0.00106600788507
"Superior frontal",("Ventral posterolateral" AND (nuclei OR nucleus)),0,1091,148,1239,0.0
"Superior frontal","Thalamic reticular",0,1091,600,1691,0.0
Putamen,(Septal AND (nuclei OR nucleus)),222,10527,4438,14965,0.0148346140996
Ambiguus,"Nucleus accumbens",31,1185,12514,13699,0.00226293890065
"Angular gyrus","Posterior parahippocampal gyrus",0,502,41,543,0.0
"Calcarine fissure",(Inferior AND collicul*),1,102,4282,4384,0.000228102189781
"Lateral geniculate","Middle temporal",27,5153,1610,6763,0.00399231110454
Cingulate,"Medial geniculate",33,11071,1216,12287,0.00268576544315
(Cochlear AND (nuclei OR nucleus)),"Wernicke's area",0,5307,251,5558,0.0
"Diagonal band of Broca",Hypothalam*,361,534,107188,107722,0.00335121887822
"Dorsolateral prefrontal","Globus pallidus",35,2969,8071,11040,0.00317028985507
"Basal forbrain",("Nucleus cuneatus" OR "cuneate nucleus"),0,1,692,693,0.0
"Basal forbrain",("Ventral posterior" AND (nuclei OR nucleus)),0,1,356,357,0.0
"Calcarine fissure",Perirhinal,0,103,1200,1303,0.0
"Broca's area",("Nucleus cuneatus" OR "cuneate nucleus"),0,694,692,1386,0.0
("Centromedian" AND (nuclei OR nucleus)),Infralimbic,2,214,494,708,0.00282485875706
Caudate,(Cochlear AND (nuclei OR nucleus)),47,18754,5260,24014,0.00195719163821
("Gustatory cortex" OR "gustatory area"),("Superior olive" OR "superior olivary"),0,153,1257,1410,0.0
("Heschl's gyrus" OR "Transverse temporal"),"Indusium griseum",0,1148,77,1225,0.0
("Inferior olive" OR "Inferior olivary"),"Middle frontal",0,2380,1028,3408,0.0
"Globus pallidus",(Medulla OR "medulla oblongata"),163,7943,50659,58602,0.00278147503498
"Globus pallidus",Fusiform,33,8073,5422,13495,0.00244535012968
Hippocamp*,("Inferior olive" OR "Inferior olivary"),160,103934,2220,106154,0.0015072441924
"Inferior temporal",Striatum,40,1671,58900,60571,0.000660382031005
Hippocamp*,"Olfactory bulb",2146,101948,9065,111013,0.0193310693342
"Inferior temporal",("Nucleus cuneatus" OR "cuneate nucleus"),0,1711,692,2403,0.0
"Inferior frontal","Nucleus basalis",0,2812,1847,4659,0.0
Infralimbic,"Postcentral gyrus",0,496,531,1027,0.0
(Medulla OR "medulla oblongata"),Thalamus,1986,48836,40896,89732,0.0221325725494
Orbitofrontal,("Red nucleus"),6,2990,2370,5360,0.00111940298507
(Medulla OR "medulla oblongata"),"Visual extrastriate",4,50818,1530,52348,7.64117062734e-05
"Posterior cingulate","Superior temporal",180,1722,3927,5649,0.0318640467339
"Middle frontal","Posterior cingulate",87,941,1815,2756,0.0315674891147
Pineal,("Superior olive" OR "superior olivary"),3,14400,1254,15654,0.000191644308164
Subgranular,Subiculum,505,127,97736,97863,0.00516027507843
Prefrontal,("Straight gyrus" OR "gyrus rectus"),24,24077,106,24183,0.000992432700657
Precuneus,Thalamus,169,1051,42713,43764,0.003861621424
"Substantia nigra","Wernicke's area",0,19387,251,19638,0.0
("Straight gyrus" OR "gyrus rectus"),("Superior olive" OR "superior olivary"),0,130,1257,1387,0.0
Ambiguus,Operculum,2,1214,924,2138,0.000935453695042
"Lateral geniculate",Precuneus,1,5179,1219,6398,0.000156298843389
Cerebellum,Subgranular,17,65383,615,65998,0.000257583563138
"Diagonal band of Broca","Pontine nuclei",9,886,789,1675,0.00537313432836
"Dorsolateral prefrontal","Visual extrastriate",17,2987,1517,4504,0.00377442273535
(Dorsomedial AND hypothal*),Infralimbic,33,2106,463,2569,0.0128454651615
"Calcarine fissure","Posterior parahippocampal gyrus",0,103,41,144,0.0
("Gustatory cortex" OR "gustatory area"),Prefrontal,11,142,24090,24232,0.000453945196434
"Broca's area",Thalamus,24,670,42858,43528,0.000551369233597
"Lateral geniculate",("Superior olive" OR "superior olivary"),12,5168,1245,6413,0.00187119912677
Caudate,"Superior temporal",124,18677,3983,22660,0.00547219770521
Cingulum,Operculum,5,680,921,1601,0.00312304809494
Cingulum,Suprachiasmatic,0,685,6026,6711,0.0
("Heschl's gyrus" OR "Transverse temporal"),(Inferior AND collicul*),12,1136,4271,5407,0.00221934529314
(Cochlear AND (nuclei OR nucleus)),Prefrontal,6,5301,24095,29396,0.00020410940264
"Inferior parietal lobule",Premotor,126,670,4603,5273,0.0238953157595
"Inferior temporal",("Mammillary body" OR "Mammillary bodies),5,1706,12,1718,0.00291036088475
Hippocamp*,(Medulla OR "medulla oblongata"),1735,102359,49087,151446,0.0114562286227
"Indusium griseum",Thalamus,4,73,42878,42951,9.31293799912e-05
"Inferior temporal",Operculum,11,1700,915,2615,0.00420650095602
"Inferior temporal","Lateral geniculate",10,1701,5170,6871,0.00145539222821
"Interstitial nucleus","Ventral tegmentum",1,513,284,797,0.00125470514429
("Nucleus cuneatus" OR "cuneate nucleus"),"Ventromedial prefrontal",0,692,3,695,0.0
"Nucleus basalis",Premotor,10,1837,4719,6556,0.00152532031727
("Nucleus cuneatus" OR "cuneate nucleus"),"Stria terminalis",7,685,2723,3408,0.00205399061033
("Mammillary body" OR "Mammillary bodies),Perirhinal,5,1364,1195,2559,0.00195388823759
("Medial dorsal" AND nucl*),Premotor,3,110,4726,4836,0.000620347394541
"Interstitial nucleus","Lingual gyrus",0,514,254,768,0.0
Insula*,Subgranular,1,17172,631,17803,5.6170308375e-05
(Inferior AND collicul*),"Supplementary motor",5,4278,2356,6634,0.000753693096171
Operculum,Putamen,36,890,10713,11603,0.00310264586745
Orbitofrontal,"Superior frontal",65,2931,1026,3957,0.0164265857973
"Nucleus accumbens",("Straight gyrus" OR "gyrus rectus"),2,12543,128,12671,0.000157840738695
"Olfactory bulb","Ventral tegmentum",17,11194,268,11462,0.00148316175188
Pons,Thalamus,2422,23162,40460,63622,0.0380685926252
"Primary auditory",(Septal AND (nuclei OR nucleus)),3,1866,4657,6523,0.000459911083857
"Posterior parahippocampal gyrus",("Superior olive" OR "superior olivary"),0,41,1257,1298,0.0
"Middle temporal",("Ventral posterior" AND (nuclei OR nucleus)),0,1637,356,1993,0.0
("Red nucleus"),("Ventral posterolateral" AND (nuclei OR nucleus)),5,2371,143,2514,0.00198886237072
"Primary motor",Temporoparietal,3,3202,1457,4659,0.00064391500322
Pulvinar,"Visual extrastriate",50,1083,1484,2567,0.0194779898714
("Nucleus gracilis" OR "gracile nucleus"),Striatum,7,367,58933,59300,0.000118043844857
Ambiguus,Pons,113,1103,25471,26574,0.0042522766614
(Intralaminar AND (nuclei OR nucleus)),Pulvinar,84,1016,1049,2065,0.0406779661017
"Angular gyrus",Premotor,31,471,4698,5169,0.00599729154575
("Centromedian" AND (nuclei OR nucleus)),"Primary sensory",1,215,3009,3224,0.00031017369727
"Dorsolateral prefrontal",("Superior olive" OR "superior olivary"),0,3004,1257,4261,0.0
"Basal forbrain","Nucleus basalis",0,1,1847,1848,0.0
"Basal forbrain","Superior temporal",0,1,4107,4108,0.0
"Broca's area","Stria terminalis",0,694,2730,3424,0.0
"Broca's area","Thalamic reticular",0,694,600,1294,0.0
Caudate,(Superior AND collicul*),312,18489,9772,28261,0.0110399490464
Claustrum,Entorhinal,660,82081,4887,86968,0.00758899825223
("Heschl's gyrus" OR "Transverse temporal"),Hypothalam*,2,1146,107547,108693,1.8400448971e-05
"Indusium griseum",Parahippocamp*,1,76,2658,2734,0.000365764447696
"Indusium griseum",("Ventral posterior" AND (nuclei OR nucleus)),0,77,356,433,0.0
"Dentate gyrus","Superior frontal",3,11440,1088,12528,0.000239463601533
"Globus pallidus",("Locus coeruleus" OR "locus ceruleus"),129,7977,7510,15487,0.00832956673339
"Inferior parietal lobule",Temporoparietal,17,779,1443,2222,0.00765076507651
"Inferior frontal",Thalamus,215,2597,42667,45264,0.00474991162955
("Inferior olive" OR "Inferior olivary"),"Ventromedial prefrontal",0,2380,3,2383,0.0
"Interstitial nucleus","Olfactory bulb",8,506,11203,11709,0.000683235118285
Insula*,Suprachiasmatic,14,17159,6012,23171,0.000604203530275
"Lingual gyrus","Piriform cortex",0,254,1743,1997,0.0
("Mammillary body" OR "Mammillary bodies),Putamen,35,1334,10714,12048,0.00290504648074
("Nucleus cuneatus" OR "cuneate nucleus"),"Posterior parietal",0,692,2154,2846,0.0
Infralimbic,"Medial frontal",27,469,1568,2037,0.0132547864507
"Medial geniculate",(Periventricular AND (nuclei OR nucleus)),19,1230,2476,3706,0.00512682137075
"Middle frontal",(Superior AND collicul*),1,1027,10083,11110,9.00090009001e-05
Insula*,"Lateral geniculate",15,17158,5165,22323,0.00067195269453
"Middle frontal","Superior frontal",161,867,930,1797,0.0895937673901
"Nucleus basalis",Operculum,2,1845,924,2769,0.000722282412423
Orbitofrontal,Perirhinal,29,2967,1171,4138,0.00700821652972
Pons,"Superior temporal",41,25543,4066,29609,0.0013847141072
("Posterior nucleus" AND hypothalamus),("Red nucleus"),0,67,2376,2443,0.0
Premotor,Striatum,256,4473,58684,63157,0.00405339075637
Perirhinal,"Visual extrastriate",5,1195,1529,2724,0.00183553597651
"Primary sensory",Suprachiasmatic,5,3005,6021,9026,0.000553955240417
"Primary sensory","Ventral tegmentum",1,3009,284,3293,0.000303674460978
"Paracentral lobule","Ventromedial prefrontal",0,65,3,68,0.0
"Middle temporal",Pulvinar,31,1606,1102,2708,0.011447562777
(Septal AND (nuclei OR nucleus)),(Superior AND collicul*),92,4568,9992,14560,0.00631868131868
Striatum,Subthalam*,1119,57821,3010,60831,0.0183952261183
"Stria terminalis",Thalamus,487,2243,42395,44638,0.0109099870066
"Piriform cortex","Superior frontal",0,1743,1091,2834,0.0
"Posterior parahippocampal gyrus",Temporoparietal,0,41,1460,1501,0.0
Putamen,("Ventral posteromedial" AND (nuclei OR nucleus)),4,10745,108,10853,0.000368561688013
"Amygdala","Superior frontal",53,23304,1038,24342,0.00217730671268
"Lateral geniculate",periaqueductal,44,5136,4532,9668,0.0045510964005
"Anterior cingulate","Olfactory bulb",12,5790,11199,16989,0.00070633939608
(Cochlear AND (nuclei OR nucleus)),Suprachiasmatic,8,5299,6018,11317,0.000706901122206
Entorhinal,("Mammillary body" OR "Mammillary bodies),45,5502,1324,6826,0.00659244066803
Cingulate,"Piriform cortex",138,10966,1605,12571,0.0109776469652
"Dorsolateral prefrontal",("Red nucleus"),1,3003,2375,5378,0.000185942729639
"Globus pallidus","Stria terminalis",131,7975,2599,10574,0.0123888783809
Ambiguus,("Ventral posteromedial" AND (nuclei OR nucleus)),4,1212,108,1320,0.0030303030303
"Calcarine fissure","Middle temporal",0,103,1637,1740,0.0
"Dorsolateral prefrontal",("Inferior olive" OR "Inferior olivary"),0,3004,2380,5384,0.0
"Amygdala",Entorhinal,915,22442,4632,27074,0.0337962620965
Caudate,Insula*,370,18431,16803,35234,0.0105012204121
"Dorsolateral prefrontal","Superior temporal",182,2822,3925,6747,0.0269749518304
"Calcarine fissure",Subthalam*,0,103,4129,4232,0.0
Caudate,periaqueductal,176,18625,4400,23025,0.00764386536374
Claustrum,Orbitofrontal,583,82158,2413,84571,0.00689361601495
Claustrum,(Periventricular AND (nuclei OR nucleus)),231,82510,2264,84774,0.00272489206596
(Cochlear AND (nuclei OR nucleus)),periaqueductal,27,5280,4549,9829,0.00274697324245
"Indusium griseum",Operculum,0,77,926,1003,0.0
Hippocamp*,(Septal AND (nuclei OR nucleus)),1596,102498,3064,105562,0.0151190769406
Hippocamp*,("Nucleus gracilis" OR "gracile nucleus"),10,104084,364,104448,9.57414215686e-05
Hippocamp*,("Ventral posteromedial" AND (nuclei OR nucleus)),7,104087,105,104192,6.71836609337e-05
("Nucleus cuneatus" OR "cuneate nucleus"),"Primary auditory",0,692,1869,2561,0.0
("Nucleus cuneatus" OR "cuneate nucleus"),(Superior AND collicul*),36,656,10048,10704,0.00336322869955
"Inferior frontal",(Intralaminar AND (nuclei OR nucleus)),1,2811,1099,3910,0.000255754475703
Parahippocamp*,Striatum,112,2547,58828,61375,0.00182484725051
Insula*,Operculum,263,16910,663,17573,0.0149661412394
(Medulla OR "medulla oblongata"),(Superior AND collicul*),645,50177,9439,59616,0.0108192431562
"Postcentral gyrus",(Raphe AND (nuclei OR nucleus)),1,530,8320,8850,0.000112994350282
Operculum,"Primary auditory",4,922,1865,2787,0.00143523501973
"Medial frontal","Primary auditory",1,1594,1868,3462,0.000288850375505
Pons,"Supplementary motor",22,25562,2339,27901,0.000788502204222
Pons,Temporoparietal,9,25575,1451,27026,0.000333012654481
Premotor,"Substantia nigra",96,4633,19291,23924,0.0040127069052
"Middle temporal",Striatum,33,1604,58907,60511,0.000545355389929
"Stria terminalis","Supplementary motor",1,2729,2360,5089,0.000196502259776
"Middle temporal","Supplementary motor",36,1601,2325,3926,0.00916963830871
Precuneus,"Supplementary motor",74,1146,2287,3433,0.0215554908244
"Ventral tegmentum","Ventromedial prefrontal",0,285,3,288,0.0
Prefrontal,"Superior frontal",281,23820,810,24630,0.0114088509947
Prefrontal,(Superior AND collicul*),141,23960,9943,33903,0.00415892398903
Ambiguus,"Medial geniculate",5,1211,1244,2455,0.0020366598778
Ambiguus,("Posterior nucleus" AND hypothalamus),1,1215,66,1281,0.000780640124902
"Anterior cingulate",Premotor,271,5531,4458,9989,0.0271298428271
"Anterior cingulate","Primary motor",109,5693,3096,8789,0.0124018659688
"Anterior cingulate","Stria terminalis",35,5767,2695,8462,0.00413613802883
"Anterior cingulate",(Septal AND (nuclei OR nucleus)),34,5768,4626,10394,0.00327111795266
"Calcarine fissure",(Dorsomedial AND hypothal*),0,103,2139,2242,0.0
(Intralaminar AND (nuclei OR nucleus)),(Raphe AND (nuclei OR nucleus)),68,1032,8253,9285,0.00732364028002
Cerebellum,("Straight gyrus" OR "gyrus rectus"),9,65391,121,65512,0.000137379411406
("Centromedian" AND (nuclei OR nucleus)),Pulvinar,19,197,1114,1311,0.0144927536232
Cingulate,Hippocamp*,2200,8904,101894,110798,0.0198559540786
"Globus pallidus",Striatum,6051,2055,52889,54944,0.110130314502
"Basal forbrain","Posterior parietal",0,1,2154,2155,0.0
("Heschl's gyrus" OR "Transverse temporal"),("Medial dorsal" AND nucl*),0,1148,113,1261,0.0
Caudate,"Dentate gyrus",340,18461,11103,29564,0.0115004735489
Caudate,Perirhinal,40,18761,1160,19921,0.00200793132875
("Gustatory cortex" OR "gustatory area"),"Primary motor",3,150,3202,3352,0.000894988066826
Caudate,("Posterior nucleus" AND hypothalamus),4,18797,63,18860,0.000212089077413
("Heschl's gyrus" OR "Transverse temporal"),"Middle frontal",15,1133,1013,2146,0.00698974836906
Cingulate,("Ventral posteromedial" AND (nuclei OR nucleus)),1,11103,111,11214,8.91742464776e-05
"Indusium griseum",(Superior AND collicul*),3,74,10081,10155,0.000295420974889
(Inferior AND collicul*),"Middle frontal",0,4283,1028,5311,0.0
Fusiform,"Stria terminalis",19,5436,2711,8147,0.0023321468025
("Inferior olive" OR "Inferior olivary"),Parahippocamp*,3,2377,2656,5033,0.000596065964633
"Globus pallidus",Pineal,9,8097,14394,22491,0.000400160064026
Hippocamp*,"Superior frontal",128,103966,963,104929,0.0012198724852
"Lingual gyrus",Pons,5,249,25579,25828,0.000193588353725
(Intralaminar AND (nuclei OR nucleus)),"Nucleus basalis",13,1087,1834,2921,0.00445053064019
("Locus coeruleus" OR "locus ceruleus"),(Medulla OR "medulla oblongata"),879,6760,49943,56703,0.0155018253002
"Nucleus basalis",Prefrontal,54,1793,24047,25840,0.00208978328173
"Inferior temporal","Superior frontal",68,1643,1023,2666,0.0255063765941
Insula*,("Ventral posterolateral" AND (nuclei OR nucleus)),0,17173,148,17321,0.0
("Medial dorsal" AND nucl*),Parahippocamp*,3,110,2656,2766,0.00108459869848
"Medial geniculate","Middle temporal",2,1247,1635,2882,0.000693962526024
periaqueductal,"Primary auditory",2,4574,1867,6441,0.00031051079025
"Medial geniculate",Pulvinar,61,1188,1072,2260,0.0269911504425
Parahippocamp*,Suprachiasmatic,3,2656,6023,8679,0.00034566194262
periaqueductal,("Ventral posteromedial" AND (nuclei OR nucleus)),6,4570,106,4676,0.00128314798973
Pons,"Visual cortex",267,25317,22613,47930,0.00557062382641
(Medulla OR "medulla oblongata"),"Ventral tegmentum",17,50805,268,51073,0.000332856891117
"Medial frontal",Pulvinar,2,1593,1131,2724,0.000734214390602
"Postcentral gyrus",("Ventral posterior" AND (nuclei OR nucleus)),2,529,354,883,0.00226500566251
Orbitofrontal,"Postcentral gyrus",18,2978,513,3491,0.00515611572615
"Paracentral lobule",("Ventral posterolateral" AND (nuclei OR nucleus)),0,65,148,213,0.0
"Nucleus basalis",Orbitofrontal,9,1838,2987,4825,0.00186528497409
"Primary sensory","Superior frontal",3,3007,1088,4095,0.000732600732601
"Primary motor",Striatum,132,3073,58808,61881,0.0021331264847
(Septal AND (nuclei OR nucleus)),"Supplementary motor",2,4658,2359,7017,0.000285022089212
"Thalamic reticular",Thalamus,529,71,42353,42424,0.0124693569678
"Visual extrastriate","Visual cortex",1070,464,21810,22274,0.0480380712939
"Substantia nigra",("Ventral anterior" AND (nuclei OR nucleus)),50,19337,187,19524,0.00256095062487
"Inferior frontal","Interstitial nucleus",0,2812,514,3326,0.0
"Anterior cingulate",("Posterior nucleus" AND hypothalamus),1,5801,66,5867,0.000170444861087
"Angular gyrus","Nucleus basalis",0,502,1847,2349,0.0
"Angular gyrus",Perirhinal,0,502,1200,1702,0.0
"Anterior cingulate",(Cochlear AND (nuclei OR nucleus)),3,5799,5304,11103,0.000270197243988
("Centromedian" AND (nuclei OR nucleus)),"Wernicke's area",0,216,251,467,0.0
"Angular gyrus",("Inferior olive" OR "Inferior olivary"),0,502,2380,2882,0.0
Entorhinal,(Raphe AND (nuclei OR nucleus)),162,5385,8159,13544,0.011961015948
"Broca's area","Posterior parietal",14,680,2140,2820,0.00496453900709
"Basal forbrain","Ventromedial prefrontal",0,1,3,4,0.0
"Basal forbrain",Putamen,0,1,10749,10750,0.0
"Broca's area",(Medulla OR "medulla oblongata"),1,693,50821,51514,1.94121986256e-05
"Calcarine fissure",("Ventral posteromedial" AND (nuclei OR nucleus)),0,103,112,215,0.0
Caudate,Claustrum,12073,6728,70668,77396,0.155989973642
("Centromedian" AND (nuclei OR nucleus)),Claustrum,78,138,82663,82801,0.000942017608483
Claustrum,"Primary auditory",46,82695,1823,84518,0.000544262760595
Claustrum,Subthalam*,1719,81022,2410,83432,0.0206036053313
"Dentate gyrus","Supplementary motor",1,11442,2360,13802,7.24532676424e-05
Claustrum,("Ventral posterolateral" AND (nuclei OR nucleus)),13,82728,135,82863,0.000156885461545
Fusiform,(Raphe AND (nuclei OR nucleus)),52,5403,8269,13672,0.00380339379754
Entorhinal,("Ventral posteromedial" AND (nuclei OR nucleus)),3,5544,109,5653,0.000530691668141
Fusiform,"Globus pallidus",33,5422,8073,13495,0.00244535012968
Hypothalam*,("Nucleus gracilis" OR "gracile nucleus"),14,107535,360,107895,0.000129755781083
Hippocamp*,"Visual cortex",807,103287,22073,125360,0.00643746011487
("Nucleus cuneatus" OR "cuneate nucleus"),Parahippocamp*,0,692,2659,3351,0.0
Parahippocamp*,(Periventricular AND (nuclei OR nucleus)),9,2650,2486,5136,0.0017523364486
"Nucleus basalis","Ventral tegmentum",6,1841,279,2120,0.00283018867925
"Medial geniculate","Superior temporal",26,1223,4081,5304,0.00490196078431
"Medial geniculate",(Medulla OR "medulla oblongata"),82,1167,50740,51907,0.00157974839617
Parahippocamp*,"Posterior parahippocampal gyrus",41,2618,0,2618,0.0156608097785
periaqueductal,"Thalamic reticular",7,4569,593,5162,0.00135606354126
(Medulla OR "medulla oblongata"),"Medial geniculate",82,50740,1167,51907,0.00157974839617
"Middle frontal",Subgranular,0,1028,632,1660,0.0
Infralimbic,Thalamus,88,408,42794,43202,0.00203694273413
("Locus coeruleus" OR "locus ceruleus"),("Posterior nucleus" AND hypothalamus),3,7636,64,7700,0.00038961038961
"Postcentral gyrus",("Ventral posteromedial" AND (nuclei OR nucleus)),0,531,112,643,0.0
(Periventricular AND (nuclei OR nucleus)),"Superior frontal",0,2495,1091,3586,0.0
Premotor,Subgranular,0,4729,632,5361,0.0
(Periventricular AND (nuclei OR nucleus)),"Pontine nuclei",11,2484,787,3271,0.00336288596759
Subthalam*,"Ventromedial prefrontal",0,4129,3,4132,0.0
"Superior frontal",Temporoparietal,8,1083,1452,2535,0.00315581854043
Pineal,"Thalamic reticular",0,14403,600,15003,0.0
"Wernicke's area","Zona incerta",0,251,974,1225,0.0
(Septal AND (nuclei OR nucleus)),("Ventral posteromedial" AND (nuclei OR nucleus)),2,4658,110,4768,0.000419463087248
("Ventral posterior" AND (nuclei OR nucleus)),"Zona incerta",11,345,963,1308,0.00840978593272
Pulvinar,"Ventral tegmentum",0,1133,285,1418,0.0
Putamen,("Superior olive" OR "superior olivary"),14,10735,1243,11978,0.00116880948405
Prefrontal,("Red nucleus"),26,24075,2350,26425,0.000983916745506
Ambiguus,"Lateral geniculate",5,1211,5175,6386,0.000782962730974
"Angular gyrus","Anterior cingulate",44,458,5758,6216,0.00707850707851
"Anterior cingulate",Hypothalam*,245,5557,107304,112861,0.00217081188364
"Anterior cingulate","Medial geniculate",3,5799,1246,7045,0.000425833924769
"Anterior cingulate",("Nucleus gracilis" OR "gracile nucleus"),0,5802,374,6176,0.0
"Basal forbrain","Globus pallidus",0,1,8106,8107,0.0
"Anterior cingulate",("Nucleus cuneatus" OR "cuneate nucleus"),1,5801,691,6492,0.000154035736291
Entorhinal,Hypothalam*,350,5197,107199,112396,0.0031139898217
"Basal forbrain",("Nucleus gracilis" OR "gracile nucleus"),0,1,374,375,0.0
"Calcarine fissure",("Nucleus gracilis" OR "gracile nucleus"),0,103,374,477,0.0
"Basal forbrain",("Red nucleus"),0,1,2376,2377,0.0
"Globus pallidus","Wernicke's area",1,8105,250,8355,0.000119688809096
Caudate,Subthalam*,281,18520,3848,22368,0.0125625894134
Cingulum,(Medulla OR "medulla oblongata"),5,680,50817,51497,9.70930345457e-05
Cingulum,"Supplementary motor",12,673,2349,3022,0.00397088021178
Claustrum,"Posterior cingulate",190,82551,1712,84263,0.00225484494974
"Dentate gyrus",(Inferior AND collicul*),68,11375,4215,15590,0.00436177036562
"Dentate gyrus","Stria terminalis",91,11352,2639,13991,0.00650418125938
Entorhinal,"Substantia nigra",202,5345,19185,24530,0.00823481451284
("Inferior olive" OR "Inferior olivary"),Thalamus,230,2150,42652,44802,0.00513369938842
"Dentate gyrus","Visual cortex",48,11395,22832,34227,0.00140240161276
"Globus pallidus",("Posterior nucleus" AND hypothalamus),1,8105,66,8171,0.000122384041121
Insula*,Subiculum,690,16483,97551,114034,0.00605082694635
"Lingual gyrus",("Ventral posterolateral" AND (nuclei OR nucleus)),0,254,148,402,0.0
"Interstitial nucleus",(Medulla OR "medulla oblongata"),82,432,50740,51172,0.00160243883374
"Lingual gyrus",Parahippocamp*,49,205,2610,2815,0.017406749556
"Nucleus basalis","Primary auditory",20,1827,1849,3676,0.00544069640914
"Medial frontal","Paracentral lobule",4,1591,61,1652,0.00242130750605
Infralimbic,"Inferior temporal",1,495,1710,2205,0.000453514739229
"Middle frontal","Thalamic reticular",0,1028,600,1628,0.0
"Postcentral gyrus",("Red nucleus"),1,530,2375,2905,0.000344234079174
"Nucleus accumbens","Wernicke's area",0,12545,251,12796,0.0
"Nucleus accumbens",("Posterior nucleus" AND hypothalamus),9,12536,58,12594,0.000714626012387
Perirhinal,(Raphe AND (nuclei OR nucleus)),34,1166,8287,9453,0.0035967417751
Orbitofrontal,"Supplementary motor",55,2941,2306,5247,0.0104821802935
Orbitofrontal,"Wernicke's area",1,2995,250,3245,0.000308166409861
Perirhinal,"Stria terminalis",30,1170,2700,3870,0.0077519379845
("Posterior nucleus" AND hypothalamus),(Septal AND (nuclei OR nucleus)),6,61,4654,4715,0.00127253446448
"Posterior parahippocampal gyrus",Premotor,0,41,4729,4770,0.0
"Posterior parahippocampal gyrus","Posterior cingulate",4,37,1898,1935,0.00206718346253
"Primary auditory","Stria terminalis",0,1869,2730,4599,0.0
"Middle frontal","Postcentral gyrus",51,977,480,1457,0.035003431709
("Ventral anterior" AND (nuclei OR nucleus)),("Ventral posterolateral" AND (nuclei OR nucleus)),7,230,141,371,0.0188679245283
("Red nucleus"),("Straight gyrus" OR "gyrus rectus"),0,2376,130,2506,0.0
Pulvinar,"Visual cortex",251,882,22629,23511,0.0106758538556
"Posterior parietal",(Septal AND (nuclei OR nucleus)),1,2153,4659,6812,0.00014679976512
Fusiform,"Superior temporal",329,5126,3778,8904,0.0369496855346
"Amygdala",("Medial dorsal" AND nucl*),17,23340,96,23436,0.000725379757638
Ambiguus,"Broca's area",3,1213,691,1904,0.0015756302521
"Amygdala","Visual extrastriate",39,23318,1495,24813,0.00157175674042
"Anterior cingulate","Posterior parahippocampal gyrus",2,5800,39,5839,0.000342524404864
Cingulate,("Mammillary body" OR "Mammillary bodies),64,11040,1305,12345,0.00518428513568
"Calcarine fissure","Indusium griseum",0,103,77,180,0.0
(Intralaminar AND (nuclei OR nucleus)),"Stria terminalis",31,1069,2699,3768,0.00822717622081
"Dentate gyrus",("Gustatory cortex" OR "gustatory area"),1,11442,152,11594,8.62515094014e-05
("Centromedian" AND (nuclei OR nucleus)),Thalamus,204,12,42678,42690,0.00477863668306
"Diagonal band of Broca","Zona incerta",25,870,949,1819,0.0137438152831
"Dorsolateral prefrontal","Ventromedial prefrontal",0,3004,3,3007,0.0
Fusiform,("Nucleus cuneatus" OR "cuneate nucleus"),4,5451,688,6139,0.00065157191725
"Dorsolateral prefrontal",("Mammillary body" OR "Mammillary bodies),2,3002,3,3005,0.000665557404326
("Gustatory cortex" OR "gustatory area"),(Intralaminar AND (nuclei OR nucleus)),0,153,1100,1253,0.0
(Dorsomedial AND hypothal*),("Mammillary body" OR "Mammillary bodies),46,2093,1323,3416,0.0134660421546
"Diagonal band of Broca",Orbitofrontal,3,892,2993,3885,0.000772200772201
"Basal forbrain","Posterior cingulate",0,1,1902,1903,0.0
"Calcarine fissure",Subgranular,0,103,632,735,0.0
("Heschl's gyrus" OR "Transverse temporal"),"Zona incerta",0,1148,974,2122,0.0
Claustrum,("Nucleus gracilis" OR "gracile nucleus"),15,82726,359,83085,0.00018053800325
("Centromedian" AND (nuclei OR nucleus)),("Nucleus cuneatus" OR "cuneate nucleus"),0,216,692,908,0.0
Claustrum,Temporoparietal,63,82678,1397,84075,0.000749330954505
Claustrum,"Wernicke's area",8,82733,243,82976,9.64134207482e-05
Hypothalam*,"Lateral geniculate",274,107275,4906,112181,0.00244248134711
Fusiform,("Ventral posterolateral" AND (nuclei OR nucleus)),1,5454,147,5601,0.00017853954651
(Inferior AND collicul*),Operculum,2,4281,924,5205,0.000384245917387
"Inferior parietal lobule","Medial geniculate",3,793,1246,2039,0.00147130946542
"Globus pallidus",Precuneus,8,8098,1212,9310,0.000859291084855
"Inferior parietal lobule",(Periventricular AND (nuclei OR nucleus)),1,795,2494,3289,0.000304043782305
Hippocamp*,Pineal,272,103822,14131,117953,0.00230600323858
"Interstitial nucleus",Precuneus,0,514,1220,1734,0.0
("Locus coeruleus" OR "locus ceruleus"),"Wernicke's area",0,7639,251,7890,0.0
"Nucleus basalis",Precuneus,0,1847,1220,3067,0.0
("Mammillary body" OR "Mammillary bodies),"Superior frontal",15,15,1089,1104,0.0135869565217
(Inferior AND collicul*),"Stria terminalis",49,4234,2681,6915,0.00708604483008
"Medial geniculate","Medial frontal",0,1249,1595,2844,0.0
"Medial geniculate",("Superior olive" OR "superior olivary"),96,1153,1161,2314,0.0414866032844
Infralimbic,(Periventricular AND (nuclei OR nucleus)),13,483,2482,2965,0.0043844856661
"Medial geniculate",Putamen,62,1187,10687,11874,0.0052214923362
Infralimbic,("Ventral anterior" AND (nuclei OR nucleus)),5,491,232,723,0.00691562932227
(Medulla OR "medulla oblongata"),(Septal AND (nuclei OR nucleus)),157,50665,4503,55168,0.00284585266821
"Nucleus accumbens","Nucleus basalis",61,12484,1786,14270,0.00427470217239
("Locus coeruleus" OR "locus ceruleus"),"Supplementary motor",6,7633,2355,9988,0.000600720865038
"Nucleus basalis","Paracentral lobule",0,1847,65,1912,0.0
Orbitofrontal,Temporoparietal,24,2972,1436,4408,0.005444646098
("Posterior nucleus" AND hypothalamus),("Ventral posterolateral" AND (nuclei OR nucleus)),1,66,147,213,0.00469483568075
("Posterior nucleus" AND hypothalamus),Suprachiasmatic,6,61,6020,6081,0.000986679822398
Pons,("Ventral anterior" AND (nuclei OR nucleus)),11,25573,226,25799,0.000426373115237
"Primary sensory",("Red nucleus"),8,3002,2368,5370,0.00148975791434
"Primary auditory",Striatum,19,1850,58921,60771,0.000312649125405
Premotor,("Ventral anterior" AND (nuclei OR nucleus)),18,4711,219,4930,0.00365111561866
"Posterior cingulate",("Ventral posterolateral" AND (nuclei OR nucleus)),0,1902,148,2050,0.0
Pineal,"Primary motor",0,14403,3205,17608,0.0
"Posterior parietal","Posterior parahippocampal gyrus",0,2154,41,2195,0.0
Precuneus,("Straight gyrus" OR "gyrus rectus"),4,1216,126,1342,0.00298062593145
Precuneus,("Superior olive" OR "superior olivary"),0,1220,1257,2477,0.0
(Raphe AND (nuclei OR nucleus)),"Stria terminalis",262,8059,2468,10527,0.0248883822552
(Raphe AND (nuclei OR nucleus)),"Superior temporal",6,8315,4101,12416,0.00048324742268
Putamen,("Ventral posterior" AND (nuclei OR nucleus)),8,10741,348,11089,0.000721435656957
"Amygdala","Nucleus accumbens",1762,21595,10783,32378,0.0544196676756
"Anterior cingulate",("Ventral posteromedial" AND (nuclei OR nucleus)),0,5802,112,5914,0.0
("Centromedian" AND (nuclei OR nucleus)),("Posterior nucleus" AND hypothalamus),0,216,67,283,0.0
Cerebellum,Cingulum,33,65367,652,66019,0.000499856102031
(Intralaminar AND (nuclei OR nucleus)),"Superior temporal",11,1089,4096,5185,0.00212150433944
(Dorsomedial AND hypothal*),("Heschl's gyrus" OR "Transverse temporal"),1,2138,1147,3285,0.000304414003044
"Dorsolateral prefrontal",("Medial dorsal" AND nucl*),5,2999,108,3107,0.0016092693917
Fusiform,"Primary sensory",5,5450,3005,8455,0.000591366055588
"Broca's area",Operculum,40,654,886,1540,0.025974025974
"Calcarine fissure","Primary motor",0,103,3205,3308,0.0
"Amygdala","Diagonal band of Broca",125,23232,770,24002,0.00520789934172
"Calcarine fissure",(Raphe AND (nuclei OR nucleus)),0,103,8321,8424,0.0
("Centromedian" AND (nuclei OR nucleus)),Insula*,6,210,17167,17377,0.000345283996087
Cingulum,Parahippocamp*,33,652,2626,3278,0.010067114094
Hypothalam*,(Medulla OR "medulla oblongata"),4440,103109,46382,149491,0.0297007846626
Hypothalam*,("Straight gyrus" OR "gyrus rectus"),10,107539,120,107659,9.28858711301e-05
"Inferior parietal lobule",Suprachiasmatic,0,796,6026,6822,0.0
"Inferior parietal lobule",("Ventral posterior" AND (nuclei OR nucleus)),0,796,356,1152,0.0
("Inferior olive" OR "Inferior olivary"),("Ventral posterior" AND (nuclei OR nucleus)),2,2378,354,2732,0.000732064421669
Hippocamp*,Parahippocamp*,1584,102510,1075,103585,0.0152917893517
"Medial frontal","Olfactory bulb",11,1584,11200,12784,0.000860450563204
"Medial geniculate","Paracentral lobule",0,1249,65,1314,0.0
Parahippocamp*,Thalamus,262,2397,42620,45017,0.00582002354666
Operculum,(Periventricular AND (nuclei OR nucleus)),1,925,2494,3419,0.000292483182217
"Pontine nuclei","Substantia nigra",109,689,19278,19967,0.00545900736215
"Primary auditory","Supplementary motor",7,1862,2354,4216,0.00166034155598
Premotor,(Superior AND collicul*),158,4571,9926,14497,0.0108988066497
Premotor,"Visual cortex",143,4586,22737,27323,0.00523368590565
"Superior frontal","Superior temporal",153,938,3954,4892,0.0312755519215
Temporoparietal,"Ventromedial prefrontal",0,1460,3,1463,0.0
Pulvinar,"Substantia nigra",33,1100,19354,20454,0.0016133763567
"Angular gyrus",Cerebellum,31,471,65369,65840,0.000470838396112
"Anterior cingulate","Inferior temporal",96,5706,1615,7321,0.01311296271
"Calcarine fissure",("Centromedian" AND (nuclei OR nucleus)),0,103,216,319,0.0
"Angular gyrus",("Ventral posterior" AND (nuclei OR nucleus)),0,502,356,858,0.0
Cerebellum,Infralimbic,8,65392,488,65880,0.000121432908318
"Amygdala","Basal forbrain",0,23357,1,23358,0.0
"Broca's area","Globus pallidus",4,690,8102,8792,0.000454959053685
("Heschl's gyrus" OR "Transverse temporal"),"Thalamic reticular",0,1148,600,1748,0.0
(Cochlear AND (nuclei OR nucleus)),Parahippocamp*,0,5307,2659,7966,0.0
"Dentate gyrus","Lingual gyrus",0,11443,254,11697,0.0
Cingulum,"Nucleus accumbens",8,677,12537,13214,0.000605418495535
Hypothalam*,"Substantia nigra",1698,105851,17689,123540,0.0137445361826
Entorhinal,Temporoparietal,16,5531,1444,6975,0.00229390681004
(Inferior AND collicul*),"Posterior parahippocampal gyrus",0,4283,41,4324,0.0
("Medial dorsal" AND nucl*),(Superior AND collicul*),7,106,10077,10183,0.000687420210154
"Nucleus basalis",Subiculum,384,1463,97857,99320,0.00386629077729
"Nucleus basalis","Visual cortex",25,1822,22855,24677,0.00101308911132
("Nucleus gracilis" OR "gracile nucleus"),Precuneus,0,374,1220,1594,0.0
"Medial geniculate","Piriform cortex",12,1237,1731,2968,0.00404312668464
Insula*,"Middle frontal",171,17002,857,17859,0.00957500419956
"Pontine nuclei","Ventromedial prefrontal",0,798,3,801,0.0
"Postcentral gyrus",(Septal AND (nuclei OR nucleus)),0,531,4660,5191,0.0
Pons,Striatum,1451,24133,57489,81622,0.0177770699076
"Middle temporal",("Ventral posterolateral" AND (nuclei OR nucleus)),0,1637,148,1785,0.0
"Superior frontal","Visual extrastriate",9,1082,1525,2607,0.00345224395857
Subiculum,("Ventral posteromedial" AND (nuclei OR nucleus)),9,98232,103,98335,9.15238724767e-05
"Angular gyrus","Superior frontal",33,469,1058,1527,0.0216110019646
"Anterior cingulate","Posterior cingulate",477,5325,1425,6750,0.0706666666667
Cerebellum,Putamen,1300,64100,9449,73549,0.0176752913024
"Dorsolateral prefrontal",Fusiform,68,2936,5387,8323,0.00817013096239
"Diagonal band of Broca",Premotor,3,892,4726,5618,0.000533997864009
Entorhinal,Premotor,21,5526,4708,10234,0.00205198358413
"Basal forbrain",Operculum,0,1,926,927,0.0
Entorhinal,("Straight gyrus" OR "gyrus rectus"),2,5545,128,5673,0.000352547153182
"Broca's area",Claustrum,38,656,82703,83359,0.000455859595245
("Gustatory cortex" OR "gustatory area"),"Posterior cingulate",3,150,1899,2049,0.00146412884334
"Broca's area","Supplementary motor",58,636,2303,2939,0.0197346036067
"Broca's area",Pons,4,690,25580,26270,0.000152264940997
Caudate,Suprachiasmatic,92,18709,5934,24643,0.00373331169095
("Centromedian" AND (nuclei OR nucleus)),Caudate,41,175,18760,18935,0.00216530235015
Claustrum,periaqueductal,427,82314,4149,86463,0.00493852861918
Cingulate,Subthalam*,75,11029,4054,15083,0.00497248557979
("Heschl's gyrus" OR "Transverse temporal"),"Inferior frontal",40,1108,2772,3880,0.0103092783505
"Dentate gyrus","Paracentral lobule",0,11443,65,11508,0.0
Cingulum,"Piriform cortex",4,681,1739,2420,0.00165289256198
"Indusium griseum","Zona incerta",0,77,974,1051,0.0
"Globus pallidus",("Nucleus cuneatus" OR "cuneate nucleus"),7,8099,685,8784,0.000796903460838
"Inferior frontal",("Ventral posterior" AND (nuclei OR nucleus)),0,2812,356,3168,0.0
"Inferior parietal lobule",(Superior AND collicul*),14,782,10070,10852,0.001290084777
"Lingual gyrus",(Medulla OR "medulla oblongata"),0,254,50822,51076,0.0
"Lingual gyrus",Suprachiasmatic,0,254,6026,6280,0.0
"Lingual gyrus","Primary motor",6,248,3199,3447,0.00174064403829
"Inferior frontal",(Medulla OR "medulla oblongata"),5,2807,50817,53624,9.32418320155e-05
Infralimbic,("Locus coeruleus" OR "locus ceruleus"),26,470,7613,8083,0.00321662748979
(Inferior AND collicul*),"Ventral tegmentum",1,4282,284,4566,0.000219010074463
Infralimbic,Operculum,0,496,926,1422,0.0
"Medial geniculate","Ventromedial prefrontal",0,1249,3,1252,0.0
(Medulla OR "medulla oblongata"),"Posterior cingulate",11,50811,1891,52702,0.000208720731661
"Middle frontal",Temporoparietal,13,1015,1447,2462,0.00528025995126
Orbitofrontal,"Substantia nigra",40,2956,19347,22303,0.00179348069766
Orbitofrontal,("Superior olive" OR "superior olivary"),0,2996,1257,4253,0.0
"Nucleus accumbens","Paracentral lobule",0,12545,65,12610,0.0
("Posterior nucleus" AND hypothalamus),"Ventromedial prefrontal",0,67,3,70,0.0
Pons,("Superior olive" OR "superior olivary"),330,25254,927,26181,0.0126045605592
(Periventricular AND (nuclei OR nucleus)),Thalamus,466,2029,42416,44445,0.0104848689391
("Straight gyrus" OR "gyrus rectus"),"Supplementary motor",2,128,2359,2487,0.000804181745074
("Straight gyrus" OR "gyrus rectus"),"Wernicke's area",0,130,251,381,0.0
Subgranular,Subthalam*,0,632,4129,4761,0.0
Prefrontal,"Ventral tegmentum",28,24073,257,24330,0.00115084258118
Ambiguus,("Nucleus cuneatus" OR "cuneate nucleus"),26,1190,666,1856,0.0140086206897
"Angular gyrus",Suprachiasmatic,0,502,6026,6528,0.0
"Angular gyrus","Ventromedial prefrontal",0,502,3,505,0.0
"Angular gyrus",Infralimbic,0,502,496,998,0.0
("Centromedian" AND (nuclei OR nucleus)),Perirhinal,2,214,1198,1412,0.0014164305949
"Anterior cingulate",Pineal,0,5802,14403,20205,0.0
(Dorsomedial AND hypothal*),("Nucleus cuneatus" OR "cuneate nucleus"),8,2131,684,2815,0.00284191829485
Cerebellum,"Dorsolateral prefrontal",217,65183,2787,67970,0.00319258496395
"Diagonal band of Broca","Posterior parahippocampal gyrus",0,895,41,936,0.0
(Dorsomedial AND hypothal*),("Ventral posteromedial" AND (nuclei OR nucleus)),1,2138,111,2249,0.000444642063139
Fusiform,Operculum,15,5440,911,6351,0.00236183278224
"Amygdala",Cingulate,1609,21748,9495,31243,0.051499535896
"Globus pallidus",("Ventral posteromedial" AND (nuclei OR nucleus)),0,8106,112,8218,0.0
"Broca's area","Diagonal band of Broca",1,693,894,1587,0.000630119722747
Caudate,Subiculum,2884,15917,95357,111274,0.0259180042058
Cingulum,"Indusium griseum",1,684,76,760,0.00131578947368
Caudate,Pineal,78,18723,14325,33048,0.0023602033406
Cingulum,"Olfactory bulb",10,675,11201,11876,0.000842034355002
Claustrum,("Red nucleus"),341,82400,2035,84435,0.00403860958133
("Gustatory cortex" OR "gustatory area"),Temporoparietal,0,153,1460,1613,0.0
(Cochlear AND (nuclei OR nucleus)),Insula*,3,5304,17170,22474,0.000133487585655
Hypothalam*,"Thalamic reticular",45,107504,555,108059,0.000416439167492
"Indusium griseum",periaqueductal,2,75,4574,4649,0.00043020004302
"Indusium griseum","Posterior parietal",0,77,2154,2231,0.0
"Inferior temporal",Premotor,45,1666,4684,6350,0.00708661417323
"Inferior parietal lobule",("Mammillary body" OR "Mammillary bodies),1,795,1,796,0.00125628140704
("Nucleus cuneatus" OR "cuneate nucleus"),("Nucleus gracilis" OR "gracile nucleus"),78,614,296,910,0.0857142857143
("Nucleus cuneatus" OR "cuneate nucleus"),Subthalam*,2,690,4127,4817,0.000415196180195
"Inferior temporal","Ventromedial prefrontal",0,1711,3,1714,0.0
"Inferior frontal","Lateral geniculate",0,2812,5180,7992,0.0
Parahippocamp*,"Posterior cingulate",207,2452,1695,4147,0.0499156016397
("Medial dorsal" AND nucl*),Pulvinar,13,100,1120,1220,0.0106557377049
periaqueductal,("Straight gyrus" OR "gyrus rectus"),3,4573,127,4700,0.00063829787234
"Medial geniculate",("Straight gyrus" OR "gyrus rectus"),0,1249,130,1379,0.0
(Medulla OR "medulla oblongata"),("Ventral posteromedial" AND (nuclei OR nucleus)),11,50811,101,50912,0.000216059082338
"Nucleus accumbens","Postcentral gyrus",3,12542,528,13070,0.000229533282326
"Nucleus accumbens","Ventral tegmentum",86,12459,199,12658,0.0067941222942
"Medial frontal","Superior frontal",83,1512,1008,2520,0.0329365079365
"Middle temporal",Premotor,72,1565,4657,6222,0.0115718418515
"Primary auditory",(Superior AND collicul*),37,1832,10047,11879,0.003114740298
Pineal,Pulvinar,5,14398,1128,15526,0.00032204044828
Perirhinal,(Septal AND (nuclei OR nucleus)),29,1171,4631,5802,0.00499827645639
("Superior olive" OR "superior olivary"),(Superior AND collicul*),442,815,9642,10457,0.0422683369991
"Stria terminalis",Subthalam*,37,2693,4092,6785,0.00545320560059
(Periventricular AND (nuclei OR nucleus)),("Superior olive" OR "superior olivary"),14,2481,1243,3724,0.00375939849624
"Posterior parietal","Primary motor",90,2064,3115,5179,0.0173778721761
"Piriform cortex","Ventral tegmentum",6,1737,279,2016,0.00297619047619
"Superior frontal","Ventral tegmentum",0,1091,285,1376,0.0
("Ventral posterolateral" AND (nuclei OR nucleus)),("Ventral posterior" AND (nuclei OR nucleus)),2,146,354,500,0.004
"Substantia nigra","Ventromedial prefrontal",0,19387,3,19390,0.0
"Amygdala",("Ventral posterior" AND (nuclei OR nucleus)),16,23341,340,23681,0.000675647143279
"Amygdala",("Ventral posteromedial" AND (nuclei OR nucleus)),10,23347,102,23449,0.000426457418227
"Angular gyrus","Visual extrastriate",9,493,1525,2018,0.00445986124876
"Lateral geniculate",Pons,183,4997,25401,30398,0.00602013290348
"Dorsolateral prefrontal",Orbitofrontal,314,2690,2682,5372,0.0584512285927
(Dorsomedial AND hypothal*),("Locus coeruleus" OR "locus ceruleus"),172,1967,7467,9434,0.0182319270723
"Dorsolateral prefrontal",Subthalam*,23,2981,4106,7087,0.00324537886271
(Dorsomedial AND hypothal*),("Ventral posterolateral" AND (nuclei OR nucleus)),0,2139,148,2287,0.0
"Broca's area",(Raphe AND (nuclei OR nucleus)),0,694,8321,9015,0.0
Caudate,(Septal AND (nuclei OR nucleus)),387,18414,4273,22687,0.0170582271786
"Basal forbrain",periaqueductal,0,1,4576,4577,0.0
Caudate,Temporoparietal,14,18787,1446,20233,0.000691938911679
Cingulum,"Visual extrastriate",1,684,1533,2217,0.000451059990979
(Cochlear AND (nuclei OR nucleus)),"Olfactory bulb",57,5250,11154,16404,0.00347476225311
Claustrum,"Medial frontal",197,82544,1398,83942,0.00234685854519
(Inferior AND collicul*),"Posterior parietal",15,4268,2139,6407,0.00234118932418
"Inferior temporal","Posterior parietal",54,1657,2100,3757,0.0143731700825
Claustrum,"Visual extrastriate",63,82678,1471,84149,0.000748671998479
"Inferior temporal","Nucleus basalis",3,1708,1844,3552,0.000844594594595
"Interstitial nucleus",Striatum,22,492,58918,59410,0.000370308028951
"Interstitial nucleus",Subiculum,17,497,98224,98721,0.000172202469586
"Lingual gyrus","Posterior parahippocampal gyrus",0,254,41,295,0.0
"Interstitial nucleus","Supplementary motor",1,513,2360,2873,0.000348068221371
("Medial dorsal" AND nucl*),Perirhinal,4,109,1196,1305,0.00306513409962
Infralimbic,"Primary motor",3,493,3202,3695,0.000811907983762
Infralimbic,Suprachiasmatic,12,484,6014,6498,0.00184672206833
Operculum,Precuneus,26,900,1194,2094,0.0124164278892
Orbitofrontal,("Posterior nucleus" AND hypothalamus),0,2996,67,3063,0.0
Orbitofrontal,"Superior temporal",156,2840,3951,6791,0.0229715800324
Perirhinal,"Substantia nigra",34,1166,19353,20519,0.0016570008285
"Paracentral lobule",("Ventral posteromedial" AND (nuclei OR nucleus)),0,65,112,177,0.0
Perirhinal,"Supplementary motor",3,1197,2358,3555,0.00084388185654
"Primary sensory",(Superior AND collicul*),19,2991,10065,13056,0.00145526960784
"Primary auditory","Superior temporal",122,1747,3985,5732,0.0212840195394
("Straight gyrus" OR "gyrus rectus"),Striatum,4,126,58936,59062,6.77254410619e-05
("Superior olive" OR "superior olivary"),"Superior temporal",2,1255,4105,5360,0.000373134328358
"Posterior parietal",Subiculum,133,2021,98108,100129,0.0013282865104
"Visual extrastriate","Wernicke's area",2,1532,249,1781,0.00112296462661
Prefrontal,"Superior temporal",728,23373,3379,26752,0.0272129186603
Parahippocamp*,"Posterior parahippocampal gyrus",41,2618,0,2618,0.0156608097785
(Raphe AND (nuclei OR nucleus)),Subthalam*,72,8249,4057,12306,0.00585080448562
"Amygdala",Insula*,1101,22256,16072,38328,0.0287257357545
"Angular gyrus",("Ventral anterior" AND (nuclei OR nucleus)),0,502,237,739,0.0
(Intralaminar AND (nuclei OR nucleus)),(Superior AND collicul*),84,1016,10000,11016,0.00762527233115
Cerebellum,Entorhinal,254,65146,5293,70439,0.00360595692727
"Broca's area",("Inferior olive" OR "Inferior olivary"),0,694,2380,3074,0.0
("Heschl's gyrus" OR "Transverse temporal"),"Nucleus basalis",0,1148,1847,2995,0.0
("Heschl's gyrus" OR "Transverse temporal"),("Posterior nucleus" AND hypothalamus),0,1148,67,1215,0.0
Cingulum,("Ventral posteromedial" AND (nuclei OR nucleus)),0,685,112,797,0.0
Claustrum,Fusiform,262,82479,5193,87672,0.0029884113514
"Inferior temporal","Pontine nuclei",3,1708,795,2503,0.00119856172593
("Inferior olive" OR "Inferior olivary"),(Medulla OR "medulla oblongata"),1403,977,49419,50396,0.0278395110723
("Inferior olive" OR "Inferior olivary"),(Septal AND (nuclei OR nucleus)),32,2348,4628,6976,0.0045871559633
("Locus coeruleus" OR "locus ceruleus"),("Ventral posterior" AND (nuclei OR nucleus)),9,7630,347,7977,0.00112824370064
("Nucleus gracilis" OR "gracile nucleus"),Operculum,0,374,926,1300,0.0
("Nucleus cuneatus" OR "cuneate nucleus"),("Ventral posteromedial" AND (nuclei OR nucleus)),1,691,111,802,0.00124688279302
Parahippocamp*,Precuneus,136,2523,1084,3607,0.0377044635431
Infralimbic,Precuneus,0,496,1220,1716,0.0
Parahippocamp*,Putamen,69,2590,10680,13270,0.0051996985682
"Medial geniculate","Primary motor",3,1246,3202,4448,0.000674460431655
Insula*,Orbitofrontal,529,16644,2467,19111,0.0276803934907
(Medulla OR "medulla oblongata"),("Ventral posterolateral" AND (nuclei OR nucleus)),9,50813,139,50952,0.000176636834668
Operculum,"Paracentral lobule",0,926,65,991,0.0
("Locus coeruleus" OR "locus ceruleus"),Thalamus,705,6934,42177,49111,0.0143552360978
Insula*,"Primary sensory",39,17134,2971,20105,0.00193981596618
Orbitofrontal,"Primary motor",15,2981,3190,6171,0.00243072435586
"Posterior cingulate","Supplementary motor",52,1850,2309,4159,0.0125030055302
"Primary sensory",Thalamus,157,2853,42725,45578,0.00344464434596
"Primary auditory","Substantia nigra",8,1861,19379,21240,0.000376647834275
("Red nucleus"),"Thalamic reticular",6,2370,594,2964,0.00202429149798
Pineal,Thalamus,275,14128,42607,56735,0.00484709614876
"Primary motor","Stria terminalis",4,3201,2726,5927,0.000674877678421
Suprachiasmatic,"Supplementary motor",0,6026,2361,8387,0.0
Suprachiasmatic,"Thalamic reticular",2,6024,598,6622,0.000302023557838
(Superior AND collicul*),("Ventral posteromedial" AND (nuclei OR nucleus)),4,10080,108,10188,0.000392618767177
"Substantia nigra","Superior frontal",8,19379,1083,20462,0.000390968624768
Parahippocamp*,"Primary auditory",4,2655,1865,4520,0.000884955752212
periaqueductal,Pons,436,4140,25148,29288,0.0148866429937
Ambiguus,"Basal forbrain",0,1216,1,1217,0.0
Ambiguus,Hypothalam*,121,1095,107428,108523,0.00111497101997
"Amygdala",Putamen,999,22358,9750,32108,0.0311137411237
Ambiguus,Putamen,20,1196,10729,11925,0.00167714884696
"Basal forbrain",Infralimbic,0,1,496,497,0.0
Cingulate,"Nucleus basalis",46,11058,1801,12859,0.00357726106229
(Intralaminar AND (nuclei OR nucleus)),Thalamus,1009,91,41873,41964,0.0240444190258
"Diagonal band of Broca","Posterior parietal",2,893,2152,3045,0.000656814449918
"Diagonal band of Broca",("Inferior olive" OR "Inferior olivary"),9,886,2371,3257,0.00276327909119
"Diagonal band of Broca","Interstitial nucleus",4,891,510,1401,0.0028551034975
"Diagonal band of Broca",periaqueductal,34,861,4542,5403,0.00629280029613
("Heschl's gyrus" OR "Transverse temporal"),("Superior olive" OR "superior olivary"),3,1145,1254,2399,0.00125052105044
"Broca's area","Ventral tegmentum",0,694,285,979,0.0
"Calcarine fissure",Subiculum,2,101,98239,98340,2.03376042302e-05
Cingulate,Pulvinar,62,11042,1071,12113,0.00511846776191
Claustrum,"Posterior parietal",155,82586,1999,84585,0.00183247620737
(Cochlear AND (nuclei OR nucleus)),"Nucleus basalis",8,5299,1839,7138,0.00112076211824
("Inferior olive" OR "Inferior olivary"),"Inferior parietal lobule",1,2379,795,3174,0.000315059861374
Hippocamp*,("Straight gyrus" OR "gyrus rectus"),22,104072,108,104180,0.00021117296986
Hypothalam*,(Inferior AND collicul*),319,107230,3964,111194,0.00286885983057
Hypothalam*,("Inferior olive" OR "Inferior olivary"),191,107358,2189,109547,0.00174354386702
Insula*,(Raphe AND (nuclei OR nucleus)),98,17075,8223,25298,0.00387382401771
Perirhinal,Pulvinar,1,1199,1132,2331,0.000429000429
"Pontine nuclei","Primary auditory",2,796,1867,2663,0.000751032669921
"Nucleus accumbens","Visual extrastriate",1,12544,1533,14077,7.10378631811e-05
"Medial frontal","Posterior cingulate",102,1493,1800,3293,0.0309747950197
"Piriform cortex","Ventromedial prefrontal",0,1743,3,1746,0.0
("Posterior nucleus" AND hypothalamus),("Superior olive" OR "superior olivary"),2,65,1255,1320,0.00151515151515
"Posterior cingulate",Striatum,117,1785,58823,60608,0.00193043822598
Pineal,"Pontine nuclei",8,14395,790,15185,0.000526835693118
Precuneus,Pulvinar,5,1215,1128,2343,0.00213401621852
"Superior temporal",Thalamus,302,3805,42580,46385,0.00651072545004
Subthalam*,("Ventral posterior" AND (nuclei OR nucleus)),5,4124,351,4475,0.00111731843575
Subiculum,"Substantia nigra",1905,96336,17482,113818,0.0167372471841
Hypothalam*,"Primary motor",23,107526,3182,110708,0.000207753730534
"Calcarine fissure","Broca's area",0,103,694,797,0.0
"Anterior cingulate",Putamen,287,5515,10462,15977,0.0179633222758
"Calcarine fissure",("Gustatory cortex" OR "gustatory area"),0,103,153,256,0.0
Cerebellum,Premotor,554,64846,4175,69021,0.00802654264644
"Anterior cingulate",Orbitofrontal,626,5176,2370,7546,0.0829578584681
"Calcarine fissure",("Medial dorsal" AND nucl*),0,103,113,216,0.0
(Dorsomedial AND hypothal*),(Superior AND collicul*),63,2076,10021,12097,0.00520790278581
"Broca's area",Subgranular,0,694,632,1326,0.0
"Amygdala","Angular gyrus",13,23344,489,23833,0.000545462174296
"Calcarine fissure","Thalamic reticular",0,103,600,703,0.0
Caudate,"Primary auditory",16,18785,1853,20638,0.000775268921407
Cingulate,("Straight gyrus" OR "gyrus rectus"),29,11075,101,11176,0.00259484609878
"Calcarine fissure","Superior temporal",2,101,4105,4206,0.000475511174513
Cingulum,Pons,14,671,25570,26241,0.000533516253192
Claustrum,Operculum,55,82686,871,83557,0.000658233301818
(Cochlear AND (nuclei OR nucleus)),("Mammillary body" OR "Mammillary bodies),5,5302,1364,6666,0.000750075007501
Claustrum,(Raphe AND (nuclei OR nucleus)),905,81836,7416,89252,0.0101398287994
("Gustatory cortex" OR "gustatory area"),Striatum,5,148,58935,59083,8.46267115752e-05
Hypothalam*,"Superior frontal",16,107533,1075,108608,0.000147318797879
Fusiform,("Red nucleus"),8,5447,2368,7815,0.00102367242482
Caudate,"Dorsolateral prefrontal",168,18633,2836,21469,0.00782523638735
"Indusium griseum","Primary auditory",0,77,1869,1946,0.0
"Dentate gyrus",(Intralaminar AND (nuclei OR nucleus)),22,11421,1078,12499,0.00176014081126
"Lingual gyrus",("Nucleus cuneatus" OR "cuneate nucleus"),0,254,692,946,0.0
"Interstitial nucleus","Posterior parahippocampal gyrus",0,514,41,555,0.0
Hippocamp*,"Ventral tegmentum",43,104051,242,104293,0.000412299962605
"Interstitial nucleus","Superior temporal",2,512,4105,4617,0.000433181719731
Infralimbic,"Lateral geniculate",2,494,5178,5672,0.000352609308886
"Nucleus basalis","Zona incerta",13,1834,961,2795,0.0046511627907
"Middle frontal",Thalamus,106,922,42776,43698,0.00242574030848
Orbitofrontal,Operculum,47,2949,879,3828,0.0122779519331
"Paracentral lobule","Visual cortex",2,63,22878,22941,8.71801577961e-05
Prefrontal,"Ventromedial prefrontal",3,24098,0,24098,0.000124491659059
"Posterior parahippocampal gyrus",("Straight gyrus" OR "gyrus rectus"),0,41,130,171,0.0
Perirhinal,"Visual cortex",42,1158,22838,23996,0.00175029171529
"Middle frontal",(Raphe AND (nuclei OR nucleus)),0,1028,8321,9349,0.0
(Septal AND (nuclei OR nucleus)),"Stria terminalis",692,3968,2038,6006,0.115218115218
"Posterior parietal",("Ventral anterior" AND (nuclei OR nucleus)),3,2151,234,2385,0.00125786163522
Precuneus,(Septal AND (nuclei OR nucleus)),0,1220,4660,5880,0.0
("Ventral posterior" AND (nuclei OR nucleus)),"Ventromedial prefrontal",0,356,3,359,0.0
Prefrontal,Putamen,743,23358,10006,33364,0.0222695120489
Pineal,"Posterior cingulate",0,14403,1902,16305,0.0
(Raphe AND (nuclei OR nucleus)),Suprachiasmatic,278,8043,5748,13791,0.0201580741063
("Nucleus cuneatus" OR "cuneate nucleus"),"Thalamic reticular",1,691,599,1290,0.00077519379845
(Raphe AND (nuclei OR nucleus)),Temporoparietal,1,8320,1459,9779,0.00010225994478
"Angular gyrus",("Centromedian" AND (nuclei OR nucleus)),0,502,216,718,0.0
"Angular gyrus","Inferior parietal lobule",37,465,759,1224,0.0302287581699
"Basal forbrain","Dentate gyrus",0,1,11443,11444,0.0
"Angular gyrus",Precuneus,51,451,1169,1620,0.0314814814815
"Angular gyrus","Primary motor",8,494,3197,3691,0.00216743429965
Cerebellum,Subthalam*,210,65190,3919,69109,0.00303867803036
"Diagonal band of Broca","Primary auditory",0,895,1869,2764,0.0
(Dorsomedial AND hypothal*),"Thalamic reticular",4,2135,596,2731,0.00146466495789
"Dorsolateral prefrontal",Striatum,225,2779,58715,61494,0.00365889355059
Fusiform,Perirhinal,20,5435,1180,6615,0.00302343159486
Fusiform,("Posterior nucleus" AND hypothalamus),0,5455,67,5522,0.0
"Globus pallidus","Superior temporal",29,8077,4078,12155,0.00238584944467
("Gustatory cortex" OR "gustatory area"),("Heschl's gyrus" OR "Transverse temporal"),0,153,1148,1301,0.0
"Broca's area","Interstitial nucleus",0,694,514,1208,0.0
"Broca's area","Paracentral lobule",1,693,64,757,0.00132100396301
Claustrum,"Pontine nuclei",93,82648,705,83353,0.00111573668614
Hypothalam*,"Interstitial nucleus",78,107471,436,107907,0.000722844671801
"Dentate gyrus",Putamen,288,11155,10461,21616,0.0133234641007
Hypothalam*,("Locus coeruleus" OR "locus ceruleus"),1820,105729,5819,111548,0.0163158460932
Entorhinal,"Stria terminalis",77,5470,2653,8123,0.00947925643235
"Interstitial nucleus",(Intralaminar AND (nuclei OR nucleus)),9,505,1091,1596,0.00563909774436
"Interstitial nucleus","Medial geniculate",12,502,1237,1739,0.00690051753882
("Nucleus gracilis" OR "gracile nucleus"),"Paracentral lobule",0,374,65,439,0.0
(Medulla OR "medulla oblongata"),("Nucleus gracilis" OR "gracile nucleus"),221,50601,153,50754,0.00435433660401
"Nucleus accumbens","Supplementary motor",5,12540,2356,14896,0.000335660580021
("Locus coeruleus" OR "locus ceruleus"),("Straight gyrus" OR "gyrus rectus"),3,7636,127,7763,0.000386448537936
("Locus coeruleus" OR "locus ceruleus"),Subgranular,1,7638,631,8269,0.00012093360745
Orbitofrontal,periaqueductal,26,2970,4550,7520,0.00345744680851
"Paracentral lobule",Putamen,8,57,10741,10798,0.000740877940359
("Posterior nucleus" AND hypothalamus),Subthalam*,2,65,4127,4192,0.000477099236641
Premotor,Putamen,190,4539,10559,15098,0.0125844482713
"Middle temporal","Postcentral gyrus",31,1606,500,2106,0.0147198480532
"Posterior parahippocampal gyrus",(Raphe AND (nuclei OR nucleus)),0,41,8321,8362,0.0
"Posterior parahippocampal gyrus",("Ventral posterior" AND (nuclei OR nucleus)),0,41,356,397,0.0
"Piriform cortex",Subthalam*,17,1726,4112,5838,0.00291195614937
"Primary motor","Wernicke's area",6,3199,245,3444,0.00174216027875
Prefrontal,("Ventral anterior" AND (nuclei OR nucleus)),24,24077,213,24290,0.000988060930424
("Red nucleus"),"Superior frontal",1,2375,1090,3465,0.0002886002886
Cerebellum,(Medulla OR "medulla oblongata"),4883,60517,45939,106456,0.0458687157135
Entorhinal,"Inferior temporal",60,5487,1651,7138,0.0084057158868
"Basal forbrain","Visual cortex",0,1,22880,22881,0.0
"Broca's area",Pineal,0,694,14403,15097,0.0
("Gustatory cortex" OR "gustatory area"),"Superior frontal",0,153,1091,1244,0.0
"Dentate gyrus","Primary auditory",3,11440,1866,13306,0.000225462197505
"Indusium griseum",Infralimbic,0,77,496,573,0.0
"Indusium griseum",(Septal AND (nuclei OR nucleus)),9,68,4651,4719,0.00190718372537
Entorhinal,"Thalamic reticular",5,5542,595,6137,0.000814730324263
Hypothalam*,Premotor,91,107458,4638,112096,0.000811804167856
"Interstitial nucleus",("Nucleus cuneatus" OR "cuneate nucleus"),10,504,682,1186,0.00843170320405
("Inferior olive" OR "Inferior olivary"),"Visual cortex",16,2364,22864,25228,0.000634215950531
("Mammillary body" OR "Mammillary bodies),Suprachiasmatic,36,1333,5990,7323,0.0049160180254
("Medial dorsal" AND nucl*),Precuneus,0,113,1220,1333,0.0
"Medial frontal",Perirhinal,15,1580,1185,2765,0.00542495479204
Hippocamp*,"Zona incerta",111,103983,863,104846,0.00105869561071
("Locus coeruleus" OR "locus ceruleus"),("Nucleus gracilis" OR "gracile nucleus"),14,7625,360,7985,0.0017532874139
(Inferior AND collicul*),(Superior AND collicul*),1391,2892,8693,11585,0.120069054812
"Inferior frontal",Pineal,0,2812,14403,17215,0.0
"Olfactory bulb","Primary sensory",58,11153,2952,14105,0.00411201701524
Operculum,"Wernicke's area",4,922,247,1169,0.00342172797263
Orbitofrontal,"Posterior parahippocampal gyrus",1,2995,40,3035,0.000329489291598
"Primary sensory",("Ventral posterolateral" AND (nuclei OR nucleus)),0,3010,148,3158,0.0
"Primary motor",(Raphe AND (nuclei OR nucleus)),14,3191,8307,11498,0.0012176030614
("Straight gyrus" OR "gyrus rectus"),"Ventral tegmentum",0,130,285,415,0.0
Precuneus,"Primary motor",19,1201,3186,4387,0.00433097788922
("Superior olive" OR "superior olivary"),"Visual cortex",4,1253,22876,24129,0.000165775622695
Putamen,Pulvinar,54,10695,1079,11774,0.00458637676236
(Raphe AND (nuclei OR nucleus)),Thalamus,828,7493,42054,49547,0.0167114053323
Parahippocamp*,"Ventromedial prefrontal",0,2659,3,2662,0.0
Ambiguus,"Pontine nuclei",12,1204,786,1990,0.00603015075377
Cingulate,"Middle frontal",327,10777,701,11478,0.0284892838474
"Diagonal band of Broca","Posterior cingulate",6,889,1896,2785,0.00215439856373
(Dorsomedial AND hypothal*),"Indusium griseum",1,2138,76,2214,0.000451671183379
"Diagonal band of Broca","Supplementary motor",0,895,2361,3256,0.0
"Dorsolateral prefrontal",("Straight gyrus" OR "gyrus rectus"),4,3000,126,3126,0.00127959053103
"Globus pallidus",Suprachiasmatic,33,8073,5993,14066,0.00234608275274
Cingulum,Fusiform,9,676,5446,6122,0.00147010780791
Caudate,("Heschl's gyrus" OR "Transverse temporal"),8,18793,1140,19933,0.000401344504089
Caudate,Prefrontal,1148,17653,22953,40606,0.0282716839876
Claustrum,(Dorsomedial AND hypothal*),200,82541,1939,84480,0.00236742424242
"Dentate gyrus","Inferior parietal lobule",1,11442,795,12237,8.1719375664e-05
("Centromedian" AND (nuclei OR nucleus)),"Middle temporal",0,216,1637,1853,0.0
"Indusium griseum",Putamen,3,74,10746,10820,0.000277264325323
"Indusium griseum",("Superior olive" OR "superior olivary"),1,76,1256,1332,0.000750750750751
("Inferior olive" OR "Inferior olivary"),Subthalam*,63,2317,4066,6383,0.00986996710011
Fusiform,("Ventral posteromedial" AND (nuclei OR nucleus)),2,5453,110,5563,0.000359518245551
("Inferior olive" OR "Inferior olivary"),"Ventral tegmentum",3,2377,282,2659,0.00112824370064
"Globus pallidus","Nucleus basalis",119,7987,1728,9715,0.0122490993309
"Inferior parietal lobule","Wernicke's area",4,792,247,1039,0.00384985563041
Hippocamp*,("Posterior nucleus" AND hypothalamus),11,104083,56,104139,0.000105628054811
"Lingual gyrus","Medial frontal",18,236,1577,1813,0.00992829564258
(Inferior AND collicul*),("Straight gyrus" OR "gyrus rectus"),0,4283,130,4413,0.0
Parahippocamp*,"Paracentral lobule",4,2655,61,2716,0.00147275405007
Parahippocamp*,"Ventral tegmentum",1,2658,284,2942,0.000339904826649
Infralimbic,("Nucleus gracilis" OR "gracile nucleus"),0,496,374,870,0.0
(Medulla OR "medulla oblongata"),"Posterior parahippocampal gyrus",0,50822,41,50863,0.0
(Medulla OR "medulla oblongata"),"Substantia nigra",630,50192,18757,68949,0.00913718835661
("Locus coeruleus" OR "locus ceruleus"),"Posterior cingulate",7,7632,1895,9527,0.000734753857458
("Locus coeruleus" OR "locus ceruleus"),"Substantia nigra",1099,6540,18288,24828,0.0442645400354
"Nucleus accumbens",periaqueductal,208,12337,4368,16705,0.0124513618677
Operculum,"Ventromedial prefrontal",0,926,3,929,0.0
"Paracentral lobule","Primary auditory",0,65,1869,1934,0.0
"Posterior parahippocampal gyrus","Zona incerta",0,41,974,1015,0.0
"Piriform cortex",Prefrontal,76,1667,24025,25692,0.00295811925891
"Posterior parietal",Pulvinar,32,2122,1101,3223,0.00992863791499
(Septal AND (nuclei OR nucleus)),("Superior olive" OR "superior olivary"),21,4639,1236,5875,0.00357446808511
"Thalamic reticular","Visual cortex",54,546,22826,23372,0.00231045695704
"Piriform cortex",("Ventral posteromedial" AND (nuclei OR nucleus)),0,1743,112,1855,0.0
"Amygdala","Zona incerta",136,23221,838,24059,0.00565277027308
"Anterior cingulate",Prefrontal,2464,3338,21637,24975,0.0986586586587
"Angular gyrus",Parahippocamp*,30,472,2629,3101,0.00967429861335
"Calcarine fissure",Fusiform,3,100,5452,5552,0.000540345821326
"Anterior cingulate","Supplementary motor",297,5505,2064,7569,0.0392390011891
("Centromedian" AND (nuclei OR nucleus)),"Postcentral gyrus",0,216,531,747,0.0
Cingulate,Pineal,9,11095,14394,25489,0.00035309349131
(Dorsomedial AND hypothal*),Precuneus,0,2139,1220,3359,0.0
"Diagonal band of Broca","Nucleus accumbens",69,826,12476,13302,0.00518718989626
Fusiform,"Medial geniculate",7,5448,1242,6690,0.00104633781764
"Basal forbrain",("Ventral posteromedial" AND (nuclei OR nucleus)),0,1,112,113,0.0
"Broca's area",Cerebellum,59,635,65341,65976,0.00089426458106
"Basal forbrain",(Septal AND (nuclei OR nucleus)),1,0,4659,4659,0.000214638334407
("Heschl's gyrus" OR "Transverse temporal"),Temporoparietal,9,1139,1451,2590,0.0034749034749
("Gustatory cortex" OR "gustatory area"),(Raphe AND (nuclei OR nucleus)),1,152,8320,8472,0.000118035882908
Cingulate,"Postcentral gyrus",100,11004,431,11435,0.008745080892
"Indusium griseum",(Intralaminar AND (nuclei OR nucleus)),0,77,1100,1177,0.0
"Indusium griseum","Nucleus accumbens",5,72,12540,12612,0.000396447827466
("Inferior olive" OR "Inferior olivary"),"Piriform cortex",18,2362,1725,4087,0.00440420846587
"Indusium griseum","Pontine nuclei",1,76,797,873,0.00114547537228
"Inferior frontal",("Ventral posteromedial" AND (nuclei OR nucleus)),1,2811,111,2922,0.000342231348392
"Inferior parietal lobule","Ventromedial prefrontal",0,796,3,799,0.0
("Inferior olive" OR "Inferior olivary"),"Nucleus accumbens",29,2351,12516,14867,0.00195062890967
"Globus pallidus",("Inferior olive" OR "Inferior olivary"),70,8036,2310,10346,0.00676589986468
"Interstitial nucleus",(Raphe AND (nuclei OR nucleus)),74,440,8247,8687,0.0085184758835
Hypothalam*,"Inferior frontal",19,107530,2793,110323,0.000172221567579
(Intralaminar AND (nuclei OR nucleus)),"Interstitial nucleus",9,1091,505,1596,0.00563909774436
("Mammillary body" OR "Mammillary bodies),"Posterior cingulate",26,26,1888,1914,0.0135841170324
"Lingual gyrus",("Straight gyrus" OR "gyrus rectus"),1,253,129,382,0.00261780104712
"Inferior frontal",Putamen,91,2721,10658,13379,0.00680170416324
Infralimbic,"Paracentral lobule",0,496,65,561,0.0
Infralimbic,periaqueductal,40,456,4536,4992,0.00801282051282
"Medial geniculate",(Septal AND (nuclei OR nucleus)),24,1225,4636,5861,0.00409486435762
"Nucleus accumbens",("Nucleus gracilis" OR "gracile nucleus"),4,12541,370,12911,0.000309813337464
("Locus coeruleus" OR "locus ceruleus"),(Septal AND (nuclei OR nucleus)),229,7410,4431,11841,0.0193395828055
"Postcentral gyrus","Stria terminalis",0,531,2730,3261,0.0
"Postcentral gyrus","Superior temporal",67,464,4040,4504,0.0148756660746
"Paracentral lobule","Stria terminalis",0,65,2730,2795,0.0
"Middle frontal","Paracentral lobule",10,1018,55,1073,0.00931966449208
(Periventricular AND (nuclei OR nucleus)),"Posterior parietal",1,2494,2153,4647,0.000215192597375
"Primary motor",("Red nucleus"),16,3189,2360,5549,0.00288340241485
"Superior frontal",("Superior olive" OR "superior olivary"),0,1091,1257,2348,0.0
Perirhinal,"Wernicke's area",0,1200,251,1451,0.0
(Superior AND collicul*),"Thalamic reticular",30,10054,570,10624,0.00282379518072
"Primary motor",("Ventral posteromedial" AND (nuclei OR nucleus)),0,3205,112,3317,0.0
Precuneus,"Ventral tegmentum",0,1220,285,1505,0.0
("Ventral anterior" AND (nuclei OR nucleus)),"Ventromedial prefrontal",0,237,3,240,0.0
"Calcarine fissure","Inferior parietal lobule",0,103,796,899,0.0
Cerebellum,"Nucleus accumbens",390,65010,12155,77165,0.00505410484028
"Diagonal band of Broca",(Dorsomedial AND hypothal*),49,846,2090,2936,0.016689373297
Cerebellum,Striatum,5139,60261,53801,114062,0.0450544440743
(Dorsomedial AND hypothal*),Parahippocamp*,10,2129,2649,4778,0.00209292591042
(Dorsomedial AND hypothal*),Premotor,25,2114,4704,6818,0.00366676444705
"Diagonal band of Broca","Inferior temporal",1,894,1710,2604,0.000384024577573
(Dorsomedial AND hypothal*),("Posterior nucleus" AND hypothalamus),8,2131,59,2190,0.00365296803653
"Diagonal band of Broca","Ventromedial prefrontal",0,895,3,898,0.0
"Dorsolateral prefrontal",Hippocamp*,284,2720,103810,106530,0.0026659157045
("Gustatory cortex" OR "gustatory area"),"Lingual gyrus",0,153,254,407,0.0
"Diagonal band of Broca",("Straight gyrus" OR "gyrus rectus"),0,895,130,1025,0.0
("Gustatory cortex" OR "gustatory area"),("Nucleus cuneatus" OR "cuneate nucleus"),0,153,692,845,0.0
"Broca's area","Middle frontal",17,677,1011,1688,0.0100710900474
"Broca's area","Superior temporal",93,601,4014,4615,0.0201516793066
Caudate,("Centromedian" AND (nuclei OR nucleus)),41,18760,175,18935,0.00216530235015
Claustrum,"Middle temporal",88,82653,1549,84202,0.00104510581696
Claustrum,("Heschl's gyrus" OR "Transverse temporal"),26,82715,1122,83837,0.000310125600868
(Cochlear AND (nuclei OR nucleus)),(Inferior AND collicul*),801,4506,3482,7988,0.10027541312
"Dentate gyrus",("Nucleus gracilis" OR "gracile nucleus"),0,11443,374,11817,0.0
"Indusium griseum",(Periventricular AND (nuclei OR nucleus)),2,75,2493,2568,0.000778816199377
Caudate,Cerebellum,1826,16975,63574,80549,0.0226694310296
"Indusium griseum","Ventromedial prefrontal",0,77,3,80,0.0
(Inferior AND collicul*),Precuneus,3,4280,1217,5497,0.000545752228488
"Interstitial nucleus",("Ventral posteromedial" AND (nuclei OR nucleus)),4,510,108,618,0.00647249190939
"Lingual gyrus",Perirhinal,0,254,1200,1454,0.0
Hippocamp*,"Posterior parahippocampal gyrus",27,104067,14,104081,0.000259413341532
("Mammillary body" OR "Mammillary bodies),(Septal AND (nuclei OR nucleus)),87,1282,4573,5855,0.0148590947908
("Mammillary body" OR "Mammillary bodies),"Stria terminalis",38,38,2693,2731,0.0139143171
"Interstitial nucleus",Subgranular,0,514,632,1146,0.0
("Inferior olive" OR "Inferior olivary"),Premotor,20,2360,4709,7069,0.00282925449144
"Medial geniculate",Striatum,65,1184,58875,60059,0.00108226910205
Infralimbic,"Middle temporal",0,496,1637,2133,0.0
(Medulla OR "medulla oblongata"),("Nucleus cuneatus" OR "cuneate nucleus"),444,50378,248,50626,0.00877019713191
(Medulla OR "medulla oblongata"),"Postcentral gyrus",9,50813,522,51335,0.00017531898315
"Postcentral gyrus",Precuneus,43,488,1177,1665,0.0258258258258
"Olfactory bulb","Posterior parahippocampal gyrus",0,11211,41,11252,0.0
"Paracentral lobule",Subthalam*,1,64,4128,4192,0.000238549618321
Orbitofrontal,Premotor,88,2908,4641,7549,0.0116571731355
("Posterior nucleus" AND hypothalamus),"Posterior parietal",0,67,2154,2221,0.0
"Posterior parahippocampal gyrus",(Septal AND (nuclei OR nucleus)),0,41,4660,4701,0.0
(Periventricular AND (nuclei OR nucleus)),"Supplementary motor",5,2490,2356,4846,0.00103177878663
"Primary auditory","Ventromedial prefrontal",0,1869,3,1872,0.0
"Stria terminalis","Ventromedial prefrontal",0,2730,3,2733,0.0
"Middle temporal",Subgranular,0,1637,632,2269,0.0
"Primary auditory","Zona incerta",1,1868,973,2841,0.00035198873636
"Superior temporal",Suprachiasmatic,2,4105,6024,10129,0.00019745285813
("Ventral posterior" AND (nuclei OR nucleus)),"Visual extrastriate",0,356,1534,1890,0.0
"Angular gyrus","Broca's area",27,475,667,1142,0.023642732049
"Anterior cingulate",Striatum,544,5258,58396,63654,0.00854620290948
"Lateral geniculate",("Nucleus cuneatus" OR "cuneate nucleus"),6,5174,686,5860,0.00102389078498
("Centromedian" AND (nuclei OR nucleus)),("Ventral posterior" AND (nuclei OR nucleus)),2,214,354,568,0.00352112676056
Entorhinal,"Middle frontal",22,5525,1006,6531,0.00336854999234
"Dorsolateral prefrontal",Premotor,224,2780,4505,7285,0.0307481125601
"Diagonal band of Broca",Perirhinal,10,885,1190,2075,0.00481927710843
Entorhinal,Fusiform,37,5510,5418,10928,0.00338579795022
Ambiguus,"Ventral tegmentum",1,1215,284,1499,0.000667111407605
"Broca's area","Primary auditory",13,681,1856,2537,0.00512416239653
("Heschl's gyrus" OR "Transverse temporal"),"Olfactory bulb",1,1147,11210,12357,8.09257910496e-05
Cingulate,Putamen,680,10424,10069,20493,0.0331820621676
Cingulum,Entorhinal,17,668,5530,6198,0.0027428202646
Claustrum,Precuneus,98,82643,1122,83765,0.00116993971229
("Centromedian" AND (nuclei OR nucleus)),("Inferior olive" OR "Inferior olivary"),4,212,2376,2588,0.0015455950541
Claustrum,(Medulla OR "medulla oblongata"),1619,81122,49203,130325,0.0124227891809
"Dentate gyrus",Subiculum,10379,1064,87862,88926,0.116715021479
Hypothalam*,("Ventral anterior" AND (nuclei OR nucleus)),31,107518,206,107724,0.000287772455535
("Inferior olive" OR "Inferior olivary"),"Superior temporal",2,2378,4105,6483,0.000308499151627
Fusiform,(Inferior AND collicul*),40,5415,4243,9658,0.00414164423276
Fusiform,Thalamus,210,5245,42672,47917,0.00438257820815
"Inferior parietal lobule","Ventral tegmentum",0,796,285,1081,0.0
"Inferior parietal lobule","Middle frontal",91,705,937,1642,0.0554202192448
"Globus pallidus",Operculum,4,8102,922,9024,0.000443262411348
"Inferior parietal lobule",("Posterior nucleus" AND hypothalamus),0,796,67,863,0.0
Insula*,"Superior frontal",141,17032,950,17982,0.00784117450784
(Intralaminar AND (nuclei OR nucleus)),"Medial frontal",7,1093,1588,2681,0.00261096605744
("Mammillary body" OR "Mammillary bodies),"Olfactory bulb",41,41,11170,11211,0.003657122469
Insula*,Striatum,483,16690,58457,75147,0.00642740229151
("Medial dorsal" AND nucl*),"Visual extrastriate",1,112,1533,1645,0.000607902735562
("Medial dorsal" AND nucl*),("Mammillary body" OR "Mammillary bodies),3,110,85,195,0.0153846153846
periaqueductal,"Ventromedial prefrontal",1,4575,2,4577,0.000218483722963
"Nucleus accumbens",Parahippocamp*,38,12507,2621,15128,0.00251189846642
"Pontine nuclei",Thalamus,145,653,42737,43390,0.00334178382116
"Piriform cortex","Visual extrastriate",0,1743,1534,3277,0.0
"Primary auditory",("Ventral anterior" AND (nuclei OR nucleus)),2,1867,235,2102,0.000951474785918
"Primary sensory","Wernicke's area",2,3008,249,3257,0.000614062020264
(Inferior AND collicul*),"Zona incerta",81,4202,893,5095,0.015897939156
"Substantia nigra","Ventral tegmentum",102,19285,183,19468,0.00523936716663
Ambiguus,"Diagonal band of Broca",8,1208,887,2095,0.00381861575179
Ambiguus,"Olfactory bulb",12,1204,11199,12403,0.000967507861001
Ambiguus,("Inferior olive" OR "Inferior olivary"),54,1162,2326,3488,0.0154816513761
"Angular gyrus",(Medulla OR "medulla oblongata"),0,502,50822,51324,0.0
"Angular gyrus",Fusiform,34,468,5421,5889,0.00577347597215
Cingulate,("Nucleus gracilis" OR "gracile nucleus"),2,11102,372,11474,0.000174307129162
Cingulate,("Posterior nucleus" AND hypothalamus),2,11102,65,11167,0.000179099131369
"Dorsolateral prefrontal","Wernicke's area",9,2995,242,3237,0.00278035217794
"Dentate gyrus","Globus pallidus",182,11261,7924,19185,0.00948657805577
Entorhinal,"Posterior parahippocampal gyrus",9,5538,32,5570,0.0016157989228
("Gustatory cortex" OR "gustatory area"),(Periventricular AND (nuclei OR nucleus)),0,153,2495,2648,0.0
"Amygdala","Dorsolateral prefrontal",200,23157,2804,25961,0.00770386348754
"Basal forbrain","Wernicke's area",0,1,251,252,0.0
"Broca's area",Hippocamp*,31,663,104063,104726,0.000296010541795
"Dentate gyrus",Premotor,2,11441,4727,16168,0.00012370113805
(Cochlear AND (nuclei OR nucleus)),Perirhinal,2,5305,1198,6503,0.000307550361372
Hypothalam*,"Medial frontal",37,107512,1558,109070,0.000339231686073
"Dentate gyrus",("Superior olive" OR "superior olivary"),12,11431,1245,12676,0.000946670874093
(Inferior AND collicul*),("Inferior olive" OR "Inferior olivary"),198,4085,2182,6267,0.0315940641455
Fusiform,(Superior AND collicul*),88,5367,9996,15363,0.00572804790731
"Inferior parietal lobule","Visual cortex",45,751,22835,23586,0.00190791147291
("Inferior olive" OR "Inferior olivary"),"Lateral geniculate",32,2348,5148,7496,0.0042689434365
"Globus pallidus","Posterior parahippocampal gyrus",0,8106,41,8147,0.0
Insula*,("Red nucleus"),24,17149,2352,19501,0.00123070611763
"Inferior temporal","Superior temporal",296,1415,3811,5226,0.0566398775354
("Medial dorsal" AND nucl*),"Primary sensory",0,113,3010,3123,0.0
("Mammillary body" OR "Mammillary bodies),Pons,66,1303,25518,26821,0.00246075836099
("Mammillary body" OR "Mammillary bodies),Parahippocamp*,23,1346,2636,3982,0.00577599196384
("Nucleus gracilis" OR "gracile nucleus"),(Superior AND collicul*),21,353,10063,10416,0.00201612903226
Infralimbic,(Raphe AND (nuclei OR nucleus)),43,453,8278,8731,0.00492497995648
Pons,"Ventral tegmentum",27,25557,258,25815,0.00104590354445
(Medulla OR "medulla oblongata"),Subthalam*,73,50749,4056,54805,0.00133199525591
"Pontine nuclei","Primary sensory",2,796,3008,3804,0.000525762355415
Insula*,("Medial dorsal" AND nucl*),12,17161,101,17262,0.00069516857838
"Pontine nuclei",(Superior AND collicul*),139,659,9945,10604,0.0131082610336
"Olfactory bulb",("Red nucleus"),47,11164,2329,13493,0.00348328763062
"Olfactory bulb","Superior frontal",1,11210,1090,12300,8.13008130081e-05
("Posterior nucleus" AND hypothalamus),"Posterior parahippocampal gyrus",0,67,41,108,0.0
(Periventricular AND (nuclei OR nucleus)),Subiculum,208,2287,98033,100320,0.00207336523126
"Primary sensory","Primary auditory",40,2970,1829,4799,0.00833506980621
"Primary sensory",("Ventral anterior" AND (nuclei OR nucleus)),0,3010,237,3247,0.0
(Medulla OR "medulla oblongata"),"Visual cortex",56,50766,22824,73590,0.000760972958282
"Middle frontal","Primary sensory",2,1026,3008,4034,0.000495785820526
"Superior temporal","Supplementary motor",126,3981,2235,6216,0.0202702702703
Pineal,Subiculum,254,14149,97987,112136,0.0022651066562
("Ventral posterolateral" AND (nuclei OR nucleus)),"Wernicke's area",0,148,251,399,0.0
Pulvinar,"Zona incerta",26,1107,948,2055,0.0126520681265
"Dorsolateral prefrontal",("Nucleus gracilis" OR "gracile nucleus"),0,3004,374,3378,0.0
Infralimbic,"Primary auditory",1,495,1868,2363,0.000423190859077
"Amygdala",Prefrontal,2441,20916,21660,42576,0.0573327696355
Ambiguus,Premotor,35,1181,4694,5875,0.00595744680851
"Anterior cingulate",Caudate,411,5391,18390,23781,0.0172827046802
("Centromedian" AND (nuclei OR nucleus)),Subgranular,0,216,632,848,0.0
Cerebellum,(Inferior AND collicul*),457,64943,3826,68769,0.00664543617037
"Broca's area","Lateral geniculate",0,694,5180,5874,0.0
("Centromedian" AND (nuclei OR nucleus)),"Inferior parietal lobule",3,213,793,1006,0.00298210735586
Caudate,Precuneus,81,18720,1139,19859,0.00407875522433
Cingulum,("Gustatory cortex" OR "gustatory area"),0,685,153,838,0.0
("Heschl's gyrus" OR "Transverse temporal"),(Septal AND (nuclei OR nucleus)),2,1146,4658,5804,0.000344589937974
Cingulate,"Primary sensory",67,11037,2943,13980,0.00479256080114
Claustrum,Hippocamp*,10032,72709,94062,166771,0.060154343381
Cingulum,("Superior olive" OR "superior olivary"),1,684,1256,1940,0.000515463917526
("Gustatory cortex" OR "gustatory area"),Suprachiasmatic,0,153,6026,6179,0.0
Entorhinal,Striatum,291,5256,58649,63905,0.00455363430092
"Dentate gyrus","Ventral tegmentum",5,11438,280,11718,0.000426693975081
Cingulum,(Superior AND collicul*),5,680,10079,10759,0.000464727205131
"Inferior temporal",Insula*,112,1599,17061,18660,0.00600214362272
"Interstitial nucleus",(Periventricular AND (nuclei OR nucleus)),19,495,2476,2971,0.00639515314709
"Interstitial nucleus","Primary motor",0,514,3205,3719,0.0
("Medial dorsal" AND nucl*),("Ventral posterolateral" AND (nuclei OR nucleus)),0,113,148,261,0.0
("Nucleus cuneatus" OR "cuneate nucleus"),("Ventral anterior" AND (nuclei OR nucleus)),0,692,237,929,0.0
"Medial geniculate","Nucleus accumbens",30,1219,12515,13734,0.00218435998253
"Inferior frontal","Primary auditory",25,2787,1844,4631,0.00539840207299
periaqueductal,"Pontine nuclei",39,4537,759,5296,0.00736404833837
Infralimbic,"Stria terminalis",68,428,2662,3090,0.0220064724919
periaqueductal,Putamen,147,4429,10602,15031,0.00977978843723
"Medial geniculate",(Raphe AND (nuclei OR nucleus)),32,1217,8289,9506,0.0033662949716
"Pontine nuclei","Supplementary motor",5,793,2356,3149,0.00158780565259
"Middle temporal",Pons,18,1619,25566,27185,0.000662129851021
"Primary auditory","Ventral tegmentum",0,1869,285,2154,0.0
"Piriform cortex",Subiculum,796,947,97445,98392,0.00809008862509
"Piriform cortex",(Septal AND (nuclei OR nucleus)),75,1668,4585,6253,0.0119942427635
"Piriform cortex",Suprachiasmatic,42,1701,5984,7685,0.00546519193234
(Superior AND collicul*),"Superior frontal",1,10083,1090,11173,8.95014767744e-05
("Ventral posterolateral" AND (nuclei OR nucleus)),"Visual extrastriate",0,148,1534,1682,0.0
Precuneus,"Ventromedial prefrontal",0,1220,3,1223,0.0
Subgranular,"Visual extrastriate",0,632,1534,2166,0.0
"Amygdala","Medial frontal",102,23255,1493,24748,0.00412154517537
"Amygdala",Perirhinal,335,23022,865,23887,0.0140243647172
"Amygdala","Piriform cortex",525,22832,1218,24050,0.0218295218295
"Anterior cingulate","Primary auditory",19,5783,1850,7633,0.00248919166776
"Angular gyrus","Primary sensory",1,501,3009,3510,0.0002849002849
Cerebellum,Claustrum,5109,60291,77632,137923,0.0370424077202
"Dorsolateral prefrontal",Operculum,26,2978,900,3878,0.00670448684889
(Dorsomedial AND hypothal*),"Posterior parahippocampal gyrus",0,2139,41,2180,0.0
"Dentate gyrus","Dorsolateral prefrontal",8,11435,2996,14431,0.000554362137066
Fusiform,"Middle frontal",98,5357,930,6287,0.0155877206935
Entorhinal,"Inferior frontal",9,5538,2803,8341,0.00107900731327
"Dorsolateral prefrontal",Putamen,119,2885,10630,13515,0.00880503144654
"Broca's area",Cingulate,58,636,11046,11682,0.00496490326999
("Heschl's gyrus" OR "Transverse temporal"),"Primary auditory",97,1051,1772,2823,0.0343606092809
"Broca's area",Orbitofrontal,7,687,2989,3676,0.0019042437432
Entorhinal,"Primary auditory",10,5537,1859,7396,0.0013520822066
("Heschl's gyrus" OR "Transverse temporal"),"Primary motor",4,1144,3201,4345,0.000920598388953
"Basal forbrain",Subthalam*,0,1,4129,4130,0.0
Claustrum,Infralimbic,127,82614,369,82983,0.0015304339443
(Cochlear AND (nuclei OR nucleus)),"Diagonal band of Broca",12,5295,883,6178,0.00194237617352
(Inferior AND collicul*),"Medial geniculate",398,3885,851,4736,0.0840371621622
Fusiform,"Supplementary motor",29,5426,2332,7758,0.00373807682392
"Inferior parietal lobule","Visual extrastriate",18,778,1516,2294,0.00784655623365
"Inferior parietal lobule",Prefrontal,204,592,23897,24489,0.0083302707338
Hippocamp*,"Pontine nuclei",132,103962,666,104628,0.00126161257025
"Medial geniculate",("Nucleus gracilis" OR "gracile nucleus"),4,1245,370,1615,0.00247678018576
Operculum,"Thalamic reticular",0,926,600,1526,0.0
"Postcentral gyrus","Wernicke's area",3,528,248,776,0.00386597938144
"Piriform cortex","Zona incerta",15,1728,959,2687,0.0055824339412
"Posterior cingulate","Thalamic reticular",0,1902,600,2502,0.0
"Postcentral gyrus","Zona incerta",0,531,974,1505,0.0
("Red nucleus"),"Ventral tegmentum",1,2375,284,2659,0.000376081233546
"Middle frontal",Pulvinar,2,1026,1131,2157,0.000927213722763
"Middle temporal",Thalamus,126,1511,42756,44267,0.0028463641087
(Septal AND (nuclei OR nucleus)),("Straight gyrus" OR "gyrus rectus"),1,4659,129,4788,0.000208855472013
(Septal AND (nuclei OR nucleus)),Suprachiasmatic,130,4530,5896,10426,0.0124688279302
("Red nucleus"),Temporoparietal,0,2376,1460,3836,0.0
"Thalamic reticular","Zona incerta",28,572,946,1518,0.0184453227931
Precuneus,Putamen,53,1167,10696,11863,0.00446767259546
"Piriform cortex","Substantia nigra",118,1625,19269,20894,0.00564755432181
Suprachiasmatic,("Ventral posterolateral" AND (nuclei OR nucleus)),0,6026,148,6174,0.0
Subiculum,(Superior AND collicul*),573,97668,9511,107179,0.0053461965497
"Substantia nigra",("Ventral posterior" AND (nuclei OR nucleus)),10,19377,346,19723,0.000507022258277
Subthalam*,Temporoparietal,1,4128,1459,5587,0.000178986933954
"Amygdala","Paracentral lobule",4,23353,61,23414,0.000170837960195
Ambiguus,(Septal AND (nuclei OR nucleus)),12,1204,4648,5852,0.00205058099795
"Anterior cingulate","Postcentral gyrus",53,5749,478,6227,0.00851132166372
"Amygdala","Thalamic reticular",18,23339,582,23921,0.00075247690314
"Anterior cingulate",(Dorsomedial AND hypothal*),28,5774,2111,7885,0.00355104629042
"Anterior cingulate","Dentate gyrus",38,5764,11405,17169,0.00221329139729
"Angular gyrus","Lingual gyrus",13,489,241,730,0.0178082191781
"Lateral geniculate","Posterior parietal",9,5171,2145,7316,0.00123018042646
"Diagonal band of Broca",Subthalam*,11,884,4118,5002,0.00219912035186
"Diagonal band of Broca",(Intralaminar AND (nuclei OR nucleus)),9,886,1091,1977,0.00455235204856
Entorhinal,"Globus pallidus",70,5477,8036,13513,0.00518019684748
"Basal forbrain","Substantia nigra",0,1,19387,19388,0.0
"Broca's area","Olfactory bulb",0,694,11211,11905,0.0
"Calcarine fissure",Temporoparietal,0,103,1460,1563,0.0
"Calcarine fissure",Putamen,0,103,10749,10852,0.0
Caudate,"Diagonal band of Broca",48,18753,847,19600,0.00244897959184
Cingulum,"Medial frontal",15,670,1580,2250,0.00666666666667
Claustrum,("Posterior nucleus" AND hypothalamus),11,82730,56,82786,0.000132872707946
Cingulate,"Visual cortex",344,10760,22536,33296,0.0103315713599
(Cochlear AND (nuclei OR nucleus)),"Medial geniculate",143,5164,1106,6270,0.0228070175439
Claustrum,"Dentate gyrus",712,82029,10731,92760,0.00767572229409
Claustrum,Insula*,1046,81695,16127,97822,0.0106928911697
Caudate,("Ventral anterior" AND (nuclei OR nucleus)),44,18757,193,18950,0.00232189973615
Cingulum,("Nucleus gracilis" OR "gracile nucleus"),0,685,374,1059,0.0
Hypothalam*,"Medial geniculate",121,107428,1128,108556,0.0011146320793
"Inferior parietal lobule","Stria terminalis",0,796,2730,3526,0.0
("Nucleus cuneatus" OR "cuneate nucleus"),"Olfactory bulb",9,683,11202,11885,0.000757257046698
("Medial dorsal" AND nucl*),"Posterior cingulate",10,103,1892,1995,0.00501253132832
("Medial dorsal" AND nucl*),"Primary auditory",0,113,1869,1982,0.0
"Inferior frontal",("Posterior nucleus" AND hypothalamus),0,2812,67,2879,0.0
Parahippocamp*,Pons,44,2615,25540,28155,0.0015627774818
("Nucleus gracilis" OR "gracile nucleus"),("Ventral posterior" AND (nuclei OR nucleus)),6,368,350,718,0.008356545961
Insula*,"Nucleus accumbens",187,16986,12358,29344,0.00637268266085
Operculum,(Raphe AND (nuclei OR nucleus)),0,926,8321,9247,0.0
"Olfactory bulb",("Ventral posterolateral" AND (nuclei OR nucleus)),3,11208,145,11353,0.000264247335506
Prefrontal,"Wernicke's area",30,24071,221,24292,0.00123497447719
"Piriform cortex",Pineal,13,1730,14390,16120,0.000806451612903
"Thalamic reticular","Ventromedial prefrontal",0,600,3,603,0.0
Thalamus,"Visual cortex",3450,39432,19430,58862,0.0586116679691
Temporoparietal,("Ventral posterolateral" AND (nuclei OR nucleus)),0,1460,148,1608,0.0
(Raphe AND (nuclei OR nucleus)),Striatum,741,7580,58199,65779,0.0112649933869
"Amygdala","Inferior temporal",108,23249,1603,24852,0.00434572670208
"Anterior cingulate",Fusiform,159,5643,5296,10939,0.0145351494652
"Calcarine fissure",("Locus coeruleus" OR "locus ceruleus"),0,103,7639,7742,0.0
"Lateral geniculate",("Ventral posteromedial" AND (nuclei OR nucleus)),3,5177,109,5286,0.000567536889898
"Dorsolateral prefrontal","Posterior parahippocampal gyrus",0,3004,41,3045,0.0
Entorhinal,(Medulla OR "medulla oblongata"),58,5489,50764,56253,0.00103105612145
"Dorsolateral prefrontal",(Raphe AND (nuclei OR nucleus)),11,2993,8310,11303,0.000973192957622
Entorhinal,Putamen,170,5377,10579,15956,0.0106542993231
"Dorsolateral prefrontal",("Nucleus cuneatus" OR "cuneate nucleus"),0,3004,692,3696,0.0
"Globus pallidus","Zona incerta",73,8033,901,8934,0.00817103201254
("Heschl's gyrus" OR "Transverse temporal"),("Straight gyrus" OR "gyrus rectus"),1,1147,129,1276,0.000783699059561
Ambiguus,Temporoparietal,0,1216,1460,2676,0.0
Fusiform,periaqueductal,30,5425,4546,9971,0.00300872530338
("Gustatory cortex" OR "gustatory area"),Putamen,2,151,10747,10898,0.00018351991191
"Dentate gyrus",Infralimbic,17,11426,479,11905,0.00142797144057
"Indusium griseum",(Medulla OR "medulla oblongata"),2,75,50820,50895,3.92965910207e-05
(Inferior AND collicul*),("Locus coeruleus" OR "locus ceruleus"),120,4163,7519,11682,0.010272213662
Hypothalam*,Parahippocamp*,97,107452,2562,110014,0.000881705964695
Fusiform,Subgranular,2,5453,630,6083,0.000328785138912
"Interstitial nucleus","Middle temporal",1,513,1636,2149,0.00046533271289
"Inferior temporal",("Ventral posterolateral" AND (nuclei OR nucleus)),0,1711,148,1859,0.0
"Interstitial nucleus","Primary sensory",0,514,3010,3524,0.0
"Lingual gyrus","Ventral tegmentum",0,254,285,539,0.0
"Lingual gyrus","Stria terminalis",0,254,2730,2984,0.0
"Lingual gyrus","Supplementary motor",16,238,2345,2583,0.00619434765776
("Medial dorsal" AND nucl*),"Medial frontal",0,113,1595,1708,0.0
(Inferior AND collicul*),"Zona incerta",81,4202,893,5095,0.015897939156
"Medial geniculate",("Nucleus cuneatus" OR "cuneate nucleus"),7,1242,685,1927,0.00363258951738
"Pontine nuclei",Pons,418,380,25166,25546,0.0163626399436
"Middle frontal","Superior temporal",205,823,3902,4725,0.0433862433862
"Middle temporal",periaqueductal,7,1630,4569,6199,0.00112921438942
Insula*,"Primary motor",117,17056,3088,20144,0.00580818109611
("Posterior nucleus" AND hypothalamus),"Primary sensory",0,67,3010,3077,0.0
"Paracentral lobule","Postcentral gyrus",7,58,524,582,0.0120274914089
"Primary motor",(Septal AND (nuclei OR nucleus)),2,3203,4658,7861,0.000254420557181
"Piriform cortex","Posterior parahippocampal gyrus",0,1743,41,1784,0.0
"Piriform cortex",Pulvinar,2,1741,1131,2872,0.000696378830084
"Thalamic reticular","Ventral tegmentum",0,600,285,885,0.0
"Posterior parietal",Striatum,61,2093,58879,60972,0.00100045922719
"Superior temporal","Ventromedial prefrontal",0,4107,3,4110,0.0
Pulvinar,("Ventral posterolateral" AND (nuclei OR nucleus)),5,1128,143,1271,0.00393391030685
(Raphe AND (nuclei OR nucleus)),"Superior frontal",3,8318,1088,9406,0.000318945354029
Putamen,"Ventromedial prefrontal",0,10749,3,10752,0.0
Putamen,"Superior temporal",128,10621,3979,14600,0.00876712328767
Subgranular,"Ventromedial prefrontal",0,632,3,635,0.0
"Substantia nigra","Zona incerta",220,19167,754,19921,0.0110436223081
Insula*,"Thalamic reticular",9,17164,591,17755,0.000506899464939
Cingulate,"Inferior parietal lobule",217,10887,579,11466,0.0189255189255
("Centromedian" AND (nuclei OR nucleus)),periaqueductal,6,210,4570,4780,0.00125523012552
(Dorsomedial AND hypothal*),Pons,108,2031,25476,27507,0.00392627331225
"Basal forbrain",("Medial dorsal" AND nucl*),0,1,113,114,0.0
"Diagonal band of Broca",(Superior AND collicul*),22,873,10062,10935,0.00201188843164
"Broca's area","Posterior cingulate",12,682,1890,2572,0.00466562986003
(Intralaminar AND (nuclei OR nucleus)),"Thalamic reticular",74,1026,526,1552,0.0476804123711
"Calcarine fissure","Zona incerta",0,103,974,1077,0.0
Caudate,("Ventral posterior" AND (nuclei OR nucleus)),9,18792,347,19139,0.000470244004389
Claustrum,"Inferior frontal",232,82509,2580,85089,0.00272655689925
"Indusium griseum",Pulvinar,0,77,1133,1210,0.0
Hypothalam*,Suprachiasmatic,3148,104401,2878,107279,0.0293440468312
Hypothalam*,("Ventral posterior" AND (nuclei OR nucleus)),25,107524,331,107855,0.000231792684623
(Inferior AND collicul*),"Olfactory bulb",126,4157,11085,15242,0.00826663167563
Entorhinal,"Visual cortex",66,5481,22814,28295,0.00233256759145
Fusiform,"Inferior parietal lobule",58,5397,738,6135,0.00945395273024
"Inferior temporal",Subgranular,0,1711,632,2343,0.0
"Lingual gyrus",Premotor,18,236,4711,4947,0.00363856882959
"Nucleus basalis",Pulvinar,9,1838,1124,2962,0.00303848750844
"Nucleus basalis",Suprachiasmatic,13,1834,6013,7847,0.00165668408309
Infralimbic,Insula*,109,387,17064,17451,0.00624606039768
Infralimbic,Perirhinal,53,443,1147,1590,0.0333333333333
"Pontine nuclei","Postcentral gyrus",0,798,531,1329,0.0
Perirhinal,Pons,17,1183,25567,26750,0.000635514018692
Insula*,"Postcentral gyrus",92,17081,439,17520,0.00525114155251
"Pontine nuclei","Superior frontal",1,797,1090,1887,0.000529941706412
"Postcentral gyrus",("Ventral anterior" AND (nuclei OR nucleus)),0,531,237,768,0.0
"Medial frontal",("Ventral posteromedial" AND (nuclei OR nucleus)),1,1594,111,1705,0.00058651026393
("Posterior nucleus" AND hypothalamus),"Posterior cingulate",0,67,1902,1969,0.0
(Periventricular AND (nuclei OR nucleus)),(Superior AND collicul*),84,2411,10000,12411,0.00676818950931
(Periventricular AND (nuclei OR nucleus)),Pineal,34,2461,14369,16830,0.0020202020202
"Middle frontal",Pons,12,1016,25572,26588,0.000451331427712
"Middle temporal","Substantia nigra",5,1632,19382,21014,0.000237936613686
"Supplementary motor","Visual extrastriate",10,2351,1524,3875,0.00258064516129
"Superior temporal",("Ventral posterolateral" AND (nuclei OR nucleus)),0,4107,148,4255,0.0
Suprachiasmatic,"Ventromedial prefrontal",0,6026,3,6029,0.0
Pulvinar,(Raphe AND (nuclei OR nucleus)),19,1114,8302,9416,0.00201784197111
Putamen,Suprachiasmatic,77,10672,5949,16621,0.00463269358041
"Wernicke's area","Visual extrastriate",2,249,1532,1781,0.00112296462661
(Inferior AND collicul*),("Ventral posterior" AND (nuclei OR nucleus)),7,4276,349,4625,0.00151351351351
"Substantia nigra","Visual cortex",102,19285,22778,42063,0.00242493402753
"Anterior cingulate",("Inferior olive" OR "Inferior olivary"),2,5800,2378,8178,0.000244558571778
"Angular gyrus",Thalamus,23,479,42859,43338,0.000530712077161
"Angular gyrus","Medial geniculate",0,502,1249,1751,0.0
"Calcarine fissure","Diagonal band of Broca",0,103,895,998,0.0
"Angular gyrus",("Red nucleus"),0,502,2376,2878,0.0
"Basal forbrain",("Heschl's gyrus" OR "Transverse temporal"),0,1,1148,1149,0.0
Cingulate,"Diagonal band of Broca",61,11043,834,11877,0.00513597709859
(Cochlear AND (nuclei OR nucleus)),Striatum,44,5263,58896,64159,0.000685796225004
Cerebellum,"Primary motor",308,65092,2897,67989,0.00453014458221
(Cochlear AND (nuclei OR nucleus)),("Superior olive" OR "superior olivary"),656,4651,601,5252,0.124904798172
(Dorsomedial AND hypothal*),"Middle temporal",5,2134,1632,3766,0.00132766861391
"Diagonal band of Broca","Substantia nigra",53,842,19334,20176,0.00262688342585
"Globus pallidus",(Septal AND (nuclei OR nucleus)),185,7921,4475,12396,0.0149241690868
"Broca's area",("Gustatory cortex" OR "gustatory area"),1,693,152,845,0.00118343195266
"Broca's area",Entorhinal,1,693,5546,6239,0.00016028209649
Cingulate,Premotor,562,10542,4167,14709,0.0382078999252
Caudate,"Visual cortex",183,18618,22697,41315,0.00442938400097
Cingulum,"Interstitial nucleus",0,685,514,1199,0.0
(Cochlear AND (nuclei OR nucleus)),("Medial dorsal" AND nucl*),2,5305,111,5416,0.000369276218612
"Indusium griseum","Lateral geniculate",1,76,5179,5255,0.000190294957184
"Dentate gyrus","Superior temporal",11,11432,4096,15528,0.000708397733127
"Indusium griseum","Ventral tegmentum",0,77,285,362,0.0
"Dentate gyrus","Inferior frontal",2,11441,2810,14251,0.0001403410287
"Indusium griseum","Visual extrastriate",0,77,1534,1611,0.0
(Inferior AND collicul*),"Posterior cingulate",5,4278,1897,6175,0.00080971659919
"Globus pallidus","Inferior parietal lobule",3,8103,793,8896,0.000337230215827
"Inferior parietal lobule",Insula*,125,671,17048,17719,0.0070545741859
"Inferior temporal",("Red nucleus"),2,1709,2374,4083,0.000489835904972
"Globus pallidus","Middle temporal",7,8099,1630,9729,0.000719498406825
"Inferior parietal lobule","Posterior cingulate",79,717,1823,2540,0.0311023622047
("Medial dorsal" AND nucl*),"Medial geniculate",10,103,1239,1342,0.00745156482861
("Nucleus cuneatus" OR "cuneate nucleus"),"Substantia nigra",25,667,19362,20029,0.00124819012432
"Inferior frontal",Premotor,228,2584,4501,7085,0.0321806633733
periaqueductal,(Superior AND collicul*),360,4216,9724,13940,0.025824964132
Infralimbic,Pulvinar,1,495,1132,1627,0.000614628149969
Parahippocamp*,("Straight gyrus" OR "gyrus rectus"),6,2653,124,2777,0.00216060496939
Parahippocamp*,Temporoparietal,19,2640,1441,4081,0.00465572163685
Perirhinal,Pineal,1,1199,14402,15601,6.40984552272e-05
"Middle temporal","Visual cortex",351,1286,22529,23815,0.0147386101197
("Locus coeruleus" OR "locus ceruleus"),periaqueductal,436,7203,4140,11343,0.0384378030503
"Posterior cingulate","Visual extrastriate",10,1892,1524,3416,0.00292740046838
("Posterior nucleus" AND hypothalamus),"Ventral tegmentum",0,67,285,352,0.0
(Medulla OR "medulla oblongata"),"Zona incerta",89,50733,885,51618,0.00172420473478
"Primary auditory","Wernicke's area",13,1856,238,2094,0.0062082139446
"Primary auditory",Pulvinar,5,1864,1128,2992,0.00167112299465
"Primary auditory","Primary sensory",40,1829,2970,4799,0.00833506980621
"Superior frontal","Zona incerta",0,1091,974,2065,0.0
Pulvinar,Temporoparietal,4,1129,1456,2585,0.00154738878143
Subiculum,Subthalam*,174,98067,3955,102022,0.00170551449687
"Substantia nigra",Subiculum,1905,17482,96336,113818,0.0167372471841
"Amygdala","Postcentral gyrus",16,23341,515,23856,0.000670690811536
"Anterior cingulate",(Intralaminar AND (nuclei OR nucleus)),28,5774,1072,6846,0.0040899795501
"Anterior cingulate","Substantia nigra",86,5716,19301,25017,0.00343766238958
"Angular gyrus",Hippocamp*,46,456,104048,104504,0.000440174538774
("Centromedian" AND (nuclei OR nucleus)),Parahippocamp*,0,216,2659,2875,0.0
(Intralaminar AND (nuclei OR nucleus)),"Postcentral gyrus",0,1100,531,1631,0.0
"Lateral geniculate",(Intralaminar AND (nuclei OR nucleus)),101,5079,999,6078,0.0166173083251
"Lateral geniculate",Operculum,4,5176,922,6098,0.0006559527714
Cerebellum,("Ventral posteromedial" AND (nuclei OR nucleus)),7,65393,105,65498,0.00010687349232
Ambiguus,Suprachiasmatic,7,1209,6019,7228,0.000968456004427
Caudate,("Inferior olive" OR "Inferior olivary"),75,18726,2305,21031,0.00356616423375
Caudate,(Dorsomedial AND hypothal*),105,18696,2034,20730,0.00506512301013
Caudate,("Ventral posterolateral" AND (nuclei OR nucleus)),8,18793,140,18933,0.000422542650399
Cingulum,"Globus pallidus",7,678,8099,8777,0.000797539022445
Cingulum,Pineal,0,685,14403,15088,0.0
("Gustatory cortex" OR "gustatory area"),"Substantia nigra",0,153,19387,19540,0.0
("Centromedian" AND (nuclei OR nucleus)),"Nucleus basalis",2,214,1845,2059,0.000971345313259
"Dentate gyrus","Medial geniculate",32,11411,1217,12628,0.00253405131454
Hypothalam*,"Primary auditory",5,107544,1864,109408,4.57004972214e-05
("Inferior olive" OR "Inferior olivary"),"Postcentral gyrus",0,2380,531,2911,0.0
Hippocamp*,"Primary motor",84,104010,3121,107131,0.000784086772269
Hippocamp*,("Nucleus cuneatus" OR "cuneate nucleus"),19,104075,673,104748,0.00018138771146
("Nucleus gracilis" OR "gracile nucleus"),"Posterior parahippocampal gyrus",0,374,41,415,0.0
"Inferior frontal","Interstitial nucleus",0,2812,514,3326,0.0
("Nucleus gracilis" OR "gracile nucleus"),"Posterior cingulate",0,374,1902,2276,0.0
Infralimbic,"Piriform cortex",12,484,1731,2215,0.00541760722348
"Nucleus accumbens","Posterior parietal",11,12534,2143,14677,0.000749471962935
"Medial frontal",("Red nucleus"),1,1594,2375,3969,0.000251952632905
Orbitofrontal,("Ventral posterolateral" AND (nuclei OR nucleus)),0,2996,148,3144,0.0
("Red nucleus"),Suprachiasmatic,11,2365,6015,8380,0.00131264916468
Pineal,"Piriform cortex",13,14390,1730,16120,0.000806451612903
Precuneus,(Superior AND collicul*),5,1215,10079,11294,0.000442712944927
Putamen,Thalamus,2031,8718,40851,49569,0.0409731888882
Subiculum,"Ventral tegmentum",43,98198,242,98440,0.000436814303129
(Raphe AND (nuclei OR nucleus)),"Zona incerta",136,8185,838,9023,0.0150725922642
("Nucleus gracilis" OR "gracile nucleus"),"Ventromedial prefrontal",0,374,3,377,0.0
Ambiguus,("Medial dorsal" AND nucl*),1,1215,112,1327,0.000753579502638
Ambiguus,"Stria terminalis",31,1185,2699,3884,0.00798146240989
"Anterior cingulate","Inferior parietal lobule",111,5691,685,6376,0.017409033877
Cerebellum,Pulvinar,36,65364,1097,66461,0.000541671055205
("Centromedian" AND (nuclei OR nucleus)),Premotor,2,214,4727,4941,0.000404776361061
"Angular gyrus","Visual cortex",24,478,22856,23334,0.00102854204166
Fusiform,Precuneus,120,5335,1100,6435,0.018648018648
"Broca's area",Fusiform,17,677,5438,6115,0.00278004905969
Caudate,"Piriform cortex",142,18659,1601,20260,0.00700888450148
Cingulum,"Posterior cingulate",30,655,1872,2527,0.011871784725
Cingulum,("Red nucleus"),1,684,2375,3059,0.000326904217064
("Inferior olive" OR "Inferior olivary"),periaqueductal,72,2308,4504,6812,0.0105695830887
"Inferior parietal lobule",("Ventral anterior" AND (nuclei OR nucleus)),1,795,236,1031,0.000969932104753
Hypothalam*,Pineal,1555,105994,12848,118842,0.0130845997206
(Intralaminar AND (nuclei OR nucleus)),("Mammillary body" OR "Mammillary bodies),14,1086,1355,2441,0.00573535436297
("Locus coeruleus" OR "locus ceruleus"),("Ventral posterolateral" AND (nuclei OR nucleus)),9,7630,139,7769,0.001158450251
("Nucleus gracilis" OR "gracile nucleus"),("Nucleus cuneatus" OR "cuneate nucleus"),78,296,614,910,0.0857142857143
("Medial dorsal" AND nucl*),Putamen,8,105,10741,10846,0.000737599114881
"Inferior frontal","Posterior parahippocampal gyrus",1,2811,40,2851,0.000350754121361
(Medulla OR "medulla oblongata"),"Olfactory bulb",393,50429,10818,61247,0.00641664081506
("Locus coeruleus" OR "locus ceruleus"),"Primary sensory",16,7623,2994,10617,0.00150701704813
("Locus coeruleus" OR "locus ceruleus"),Subthalam*,78,7561,4051,11612,0.00671718911471
"Postcentral gyrus","Thalamic reticular",0,531,600,1131,0.0
"Medial frontal",Striatum,126,1469,58814,60283,0.00209014149926
"Middle frontal",("Ventral posterior" AND (nuclei OR nucleus)),0,1028,356,1384,0.0
"Postcentral gyrus",("Ventral posterolateral" AND (nuclei OR nucleus)),0,531,148,679,0.0
"Posterior cingulate",("Posterior nucleus" AND hypothalamus),0,1902,67,1969,0.0
"Posterior cingulate",Precuneus,404,1498,816,2314,0.174589455488
"Posterior cingulate",("Straight gyrus" OR "gyrus rectus"),2,1900,128,2028,0.000986193293886
Perirhinal,("Superior olive" OR "superior olivary"),0,1200,1257,2457,0.0
"Superior frontal",("Ventral posteromedial" AND (nuclei OR nucleus)),0,1091,112,1203,0.0
("Ventral posterolateral" AND (nuclei OR nucleus)),"Zona incerta",2,146,972,1118,0.00178890876565
Putamen,Temporoparietal,18,10731,1442,12173,0.00147868232975
"Calcarine fissure",Hypothalam*,0,103,107549,107652,0.0
Cerebellum,"Inferior parietal lobule",107,65293,689,65982,0.00162165439059
(Dorsomedial AND hypothal*),"Globus pallidus",37,2102,8069,10171,0.00363779372726
"Calcarine fissure",("Straight gyrus" OR "gyrus rectus"),0,103,130,233,0.0
Caudate,"Paracentral lobule",7,18794,58,18852,0.0003713133885
Caudate,Entorhinal,198,18603,5349,23952,0.00826653306613
Caudate,"Inferior frontal",142,18659,2670,21329,0.00665760232547
Caudate,"Zona incerta",79,18722,895,19617,0.00402711933527
Cingulum,("Medial dorsal" AND nucl*),0,685,113,798,0.0
(Cochlear AND (nuclei OR nucleus)),Pineal,6,5301,14397,19698,0.000304599451721
(Cochlear AND (nuclei OR nucleus)),Fusiform,159,5148,5296,10444,0.0152240520873
"Dentate gyrus",(Superior AND collicul*),120,11323,9964,21287,0.00563724338798
"Indusium griseum","Interstitial nucleus",0,77,514,591,0.0
"Indusium griseum",("Ventral posterolateral" AND (nuclei OR nucleus)),0,77,148,225,0.0
Hypothalam*,"Posterior cingulate",52,107497,1850,109347,0.000475550312309
("Inferior olive" OR "Inferior olivary"),Insula*,13,2367,17160,19527,0.000665744866083
"Lingual gyrus","Posterior cingulate",36,218,1866,2084,0.0172744721689
("Nucleus cuneatus" OR "cuneate nucleus"),periaqueductal,20,672,4556,5228,0.00382555470543
("Medial dorsal" AND nucl*),"Postcentral gyrus",0,113,531,644,0.0
"Inferior frontal",(Periventricular AND (nuclei OR nucleus)),1,2811,2494,5305,0.000188501413761
"Inferior frontal",Infralimbic,0,2812,496,3308,0.0
"Medial geniculate","Supplementary motor",2,1247,2359,3606,0.000554631170272
"Inferior frontal","Lingual gyrus",52,2760,202,2962,0.0175557056043
Infralimbic,"Wernicke's area",0,496,251,747,0.0
Insula*,Premotor,324,16849,4405,21254,0.0152441893291
Pons,Subiculum,1928,23656,96313,119969,0.0160708182947
Premotor,("Red nucleus"),49,4680,2327,7007,0.00699300699301
Premotor,("Ventral posterior" AND (nuclei OR nucleus)),5,4724,351,5075,0.000985221674877
"Primary auditory",Subthalam*,4,1865,4125,5990,0.000667779632721
"Middle temporal","Primary sensory",7,1630,3003,4633,0.00151090006475
("Red nucleus"),"Visual extrastriate",0,2376,1534,3910,0.0
Pineal,"Zona incerta",9,14394,965,15359,0.000585975649456
"Posterior parahippocampal gyrus","Visual cortex",2,39,22878,22917,8.72714578697e-05
"Supplementary motor","Wernicke's area",10,2351,241,2592,0.00385802469136
Pulvinar,(Superior AND collicul*),245,888,9839,10727,0.0228395637177
Pulvinar,"Thalamic reticular",21,1112,579,1691,0.0124186871674
Pulvinar,Suprachiasmatic,5,1128,6021,7149,0.000699398517275
Subiculum,"Thalamic reticular",39,98202,561,98763,0.000394884724036
"Amygdala",("Straight gyrus" OR "gyrus rectus"),15,23342,115,23457,0.000639467962655
"Amygdala","Supplementary motor",31,23326,2330,25656,0.0012082943561
Cerebellum,periaqueductal,208,65192,4368,69560,0.00299022426682
"Lateral geniculate","Lingual gyrus",0,5180,254,5434,0.0
"Angular gyrus","Pontine nuclei",0,502,798,1300,0.0
"Lateral geniculate",Perirhinal,9,5171,1191,6362,0.0014146494813
Cingulate,(Cochlear AND (nuclei OR nucleus)),18,11086,5289,16375,0.00109923664122
"Lateral geniculate",(Periventricular AND (nuclei OR nucleus)),32,5148,2463,7611,0.00420444094074
"Diagonal band of Broca",Precuneus,0,895,1220,2115,0.0
"Lateral geniculate","Visual cortex",1802,3378,21078,24456,0.0736833496892
Ambiguus,"Visual extrastriate",0,1216,1534,2750,0.0
"Broca's area","Dentate gyrus",0,694,11443,12137,0.0
"Broca's area",periaqueductal,3,691,4573,5264,0.00056990881459
"Calcarine fissure","Primary sensory",2,101,3008,3109,0.000643293663557
("Centromedian" AND (nuclei OR nucleus)),Cingulate,9,207,11095,11302,0.000796319235534
Claustrum,("Gustatory cortex" OR "gustatory area"),25,82716,128,82844,0.000301772005215
"Dentate gyrus",Subgranular,466,10977,166,11143,0.041819976667
"Globus pallidus",(Periventricular AND (nuclei OR nucleus)),56,8050,2439,10489,0.00533892649442
Fusiform,"Inferior temporal",220,5235,1491,6726,0.0327088908712
"Inferior temporal",Precuneus,71,1640,1149,2789,0.0254571531015
("Inferior olive" OR "Inferior olivary"),"Medial geniculate",42,2338,1207,3545,0.0118476727786
("Medial dorsal" AND nucl*),("Nucleus gracilis" OR "gracile nucleus"),1,112,373,485,0.0020618556701
(Intralaminar AND (nuclei OR nucleus)),"Paracentral lobule",0,1100,65,1165,0.0
"Medial geniculate","Nucleus basalis",5,1244,1842,3086,0.00162022034997
(Medulla OR "medulla oblongata"),Putamen,234,50588,10515,61103,0.00382959920135
Infralimbic,"Thalamic reticular",2,494,598,1092,0.0018315018315
"Olfactory bulb","Posterior cingulate",4,11207,1898,13105,0.000305227012591
"Middle temporal","Wernicke's area",21,1616,230,1846,0.0113759479957
Orbitofrontal,Suprachiasmatic,3,2993,6023,9016,0.000332741792369
"Middle frontal","Olfactory bulb",2,1026,11209,12235,0.00016346546792
("Straight gyrus" OR "gyrus rectus"),Subiculum,20,110,98221,98331,0.000203394656822
"Stria terminalis",Suprachiasmatic,227,2503,5799,8302,0.0273428089617
Striatum,"Supplementary motor",156,58784,2205,60989,0.00255783829871
"Superior frontal",(Superior AND collicul*),1,1090,10083,11173,8.95014767744e-05
"Ventromedial prefrontal","Visual cortex",0,3,22880,22883,0.0
Putamen,(Raphe AND (nuclei OR nucleus)),231,10518,8090,18608,0.0124140154772
"Primary motor","Ventral tegmentum",1,3204,284,3488,0.000286697247706
"Medial geniculate",("Ventral anterior" AND (nuclei OR nucleus)),5,1244,232,1476,0.00338753387534
"Basal forbrain",Caudate,0,1,18801,18802,0.0
Cingulate,"Middle temporal",264,10840,1373,12213,0.0216163104888
(Dorsomedial AND hypothal*),(Medulla OR "medulla oblongata"),265,1874,50557,52431,0.00505426179169
("Gustatory cortex" OR "gustatory area"),Orbitofrontal,12,141,2984,3125,0.00384
"Basal forbrain","Thalamic reticular",0,1,600,601,0.0
"Basal forbrain",("Posterior nucleus" AND hypothalamus),0,1,67,68,0.0
("Gustatory cortex" OR "gustatory area"),"Pontine nuclei",0,153,798,951,0.0
Caudate,("Locus coeruleus" OR "locus ceruleus"),258,18543,7381,25924,0.00995216787533
"Broca's area",Perirhinal,1,693,1199,1892,0.000528541226216
Caudate,Striatum,11415,7386,47525,54911,0.207881845168
Claustrum,"Diagonal band of Broca",130,82611,765,83376,0.00155920168874
"Dentate gyrus",Prefrontal,190,11253,23911,35164,0.00540325332727
(Inferior AND collicul*),("Nucleus gracilis" OR "gracile nucleus"),19,4264,355,4619,0.0041134444685
("Inferior olive" OR "Inferior olivary"),"Olfactory bulb",59,2321,11152,13473,0.00437912862763
"Inferior parietal lobule","Piriform cortex",0,796,1743,2539,0.0
"Inferior parietal lobule",("Ventral posterolateral" AND (nuclei OR nucleus)),2,794,146,940,0.00212765957447
"Inferior temporal","Posterior parahippocampal gyrus",2,1709,39,1748,0.00114416475973
"Inferior parietal lobule","Lateral geniculate",3,793,5177,5970,0.000502512562814
Hippocamp*,("Ventral anterior" AND (nuclei OR nucleus)),15,104079,222,104301,0.000143814536773
"Inferior parietal lobule",("Nucleus cuneatus" OR "cuneate nucleus"),0,796,692,1488,0.0
("Nucleus cuneatus" OR "cuneate nucleus"),Suprachiasmatic,4,688,6022,6710,0.000596125186289
("Nucleus cuneatus" OR "cuneate nucleus"),Pons,88,604,25496,26100,0.00337164750958
("Medial dorsal" AND nucl*),Subiculum,21,92,98220,98312,0.000213605663602
(Inferior AND collicul*),"Wernicke's area",0,4283,251,4534,0.0
(Medulla OR "medulla oblongata"),"Middle frontal",2,50820,1026,51846,3.8575782124e-05
"Middle frontal","Substantia nigra",8,1020,19379,20399,0.000392176087063
"Pontine nuclei",("Ventral posteromedial" AND (nuclei OR nucleus)),1,797,111,908,0.0011013215859
Operculum,"Visual extrastriate",6,920,1528,2448,0.00245098039216
"Paracentral lobule",(Raphe AND (nuclei OR nucleus)),0,65,8321,8386,0.0
Pons,Suprachiasmatic,67,25517,5959,31476,0.00212860592197
Prefrontal,"Zona incerta",32,24069,942,25011,0.0012794370477
"Olfactory bulb",(Superior AND collicul*),206,11005,9878,20883,0.00986448307236
("Straight gyrus" OR "gyrus rectus"),(Superior AND collicul*),0,130,10084,10214,0.0
Subthalam*,"Visual extrastriate",0,4129,1534,5663,0.0
Striatum,"Visual extrastriate",34,58906,1500,60406,0.000562857994239
"Posterior parietal",(Raphe AND (nuclei OR nucleus)),3,2151,8318,10469,0.000286560320948
"Piriform cortex",Thalamus,222,1521,42660,44181,0.00502478440959
"Supplementary motor",Suprachiasmatic,0,2361,6026,8387,0.0
"Primary motor",(Superior AND collicul*),17,3188,10067,13255,0.00128253489249
Pulvinar,"Superior frontal",2,1131,1089,2220,0.000900900900901
Subgranular,"Superior frontal",0,632,1091,1723,0.0
"Substantia nigra",("Superior olive" OR "superior olivary"),39,19348,1218,20566,0.00189633375474
"Visual cortex","Visual extrastriate",1070,21810,464,22274,0.0480380712939
"Amygdala","Posterior cingulate",204,23153,1698,24851,0.00820892519416
"Anterior cingulate",Subiculum,741,5061,97500,102561,0.0072249685553
(Intralaminar AND (nuclei OR nucleus)),Precuneus,1,1099,1219,2318,0.000431406384814
Cerebellum,("Red nucleus"),724,64676,1652,66328,0.0109154504885
("Centromedian" AND (nuclei OR nucleus)),Subiculum,19,197,98222,98419,0.000193052154564
(Dorsomedial AND hypothal*),("Ventral anterior" AND (nuclei OR nucleus)),7,2132,230,2362,0.00296359017782
"Broca's area",Prefrontal,123,571,23978,24549,0.00501038738849
"Broca's area","Basal forbrain",0,694,1,695,0.0
"Broca's area",(Superior AND collicul*),1,693,10083,10776,9.27988121752e-05
Cingulate,"Thalamic reticular",10,11094,590,11684,0.00085587127696
Hypothalam*,Perirhinal,93,107456,1107,108563,0.000856645450107
("Gustatory cortex" OR "gustatory area"),"Wernicke's area",0,153,251,404,0.0
"Inferior temporal",("Straight gyrus" OR "gyrus rectus"),5,1706,125,1831,0.00273074822501
("Locus coeruleus" OR "locus ceruleus"),("Ventral posteromedial" AND (nuclei OR nucleus)),0,7639,112,7751,0.0
Hippocamp*,"Ventromedial prefrontal",0,104094,3,104097,0.0
("Mammillary body" OR "Mammillary bodies),("Nucleus gracilis" OR "gracile nucleus"),0,0,374,374,0.0
"Lingual gyrus","Posterior parietal",7,247,2147,2394,0.00292397660819
("Mammillary body" OR "Mammillary bodies),"Medial frontal",35,35,1594,1629,0.0214855739718
Insula*,"Substantia nigra",122,17051,19265,36316,0.00335940081507
"Nucleus basalis","Posterior parietal",7,1840,2147,3987,0.00175570604465
"Inferior temporal",Orbitofrontal,57,1654,2939,4593,0.0124101894187
"Inferior frontal","Postcentral gyrus",58,2754,473,3227,0.0179733498606
Parahippocamp*,Pineal,1,2658,14402,17060,5.86166471278e-05
"Inferior frontal",(Septal AND (nuclei OR nucleus)),1,2811,4659,7470,0.000133868808568
("Nucleus gracilis" OR "gracile nucleus"),Suprachiasmatic,0,374,6026,6400,0.0
(Inferior AND collicul*),"Visual extrastriate",7,4276,1527,5803,0.00120627261761
"Nucleus accumbens",(Superior AND collicul*),151,12394,9933,22327,0.00676311192726
("Locus coeruleus" OR "locus ceruleus"),"Superior temporal",12,7627,4095,11722,0.0010237160894
Pons,(Septal AND (nuclei OR nucleus)),159,25425,4501,29926,0.00531310566063
(Periventricular AND (nuclei OR nucleus)),"Primary sensory",5,2490,3005,5495,0.00090991810737
"Middle frontal",("Nucleus gracilis" OR "gracile nucleus"),0,1028,374,1402,0.0
(Septal AND (nuclei OR nucleus)),"Zona incerta",66,4594,908,5502,0.0119956379498
Pineal,("Red nucleus"),11,14392,2365,16757,0.000656442083905
"Middle frontal",Putamen,43,985,10706,11691,0.00367804293901
("Straight gyrus" OR "gyrus rectus"),"Superior temporal",9,121,4098,4219,0.00213320692107
Pineal,"Superior frontal",0,14403,1091,15494,0.0
("Ventral anterior" AND (nuclei OR nucleus)),Thalamus,197,40,42685,42725,0.00461088355764
Prefrontal,Premotor,973,23128,3756,26884,0.0361925308734
Infralimbic,"Posterior parietal",2,494,2152,2646,0.000755857898715
Parahippocamp*,"Posterior cingulate",207,2452,1695,4147,0.0499156016397
"Amygdala",(Medulla OR "medulla oblongata"),827,22530,49995,72525,0.011402964495
"Amygdala",Precuneus,80,23277,1140,24417,0.00327640578286
"Dorsolateral prefrontal",("Posterior nucleus" AND hypothalamus),0,3004,67,3071,0.0
(Dorsomedial AND hypothal*),"Dorsolateral prefrontal",4,2135,3000,5135,0.000778967867575
"Diagonal band of Broca","Lingual gyrus",0,895,254,1149,0.0
(Dorsomedial AND hypothal*),(Intralaminar AND (nuclei OR nucleus)),24,2115,1076,3191,0.0075211532435
Entorhinal,"Postcentral gyrus",2,5545,529,6074,0.000329272308199
"Dorsolateral prefrontal","Superior frontal",66,2938,1025,3963,0.0166540499621
("Gustatory cortex" OR "gustatory area"),"Olfactory bulb",4,149,11207,11356,0.000352236703064
"Calcarine fissure",(Periventricular AND (nuclei OR nucleus)),0,103,2495,2598,0.0
("Heschl's gyrus" OR "Transverse temporal"),Parahippocamp*,24,1124,2635,3759,0.00638467677574
Cingulate,"Substantia nigra",293,10811,19094,29905,0.00979769269353
Cingulum,"Ventral tegmentum",0,685,285,970,0.0
Cingulum,"Posterior parahippocampal gyrus",0,685,41,726,0.0
"Dentate gyrus",Orbitofrontal,14,11429,2982,14411,0.000971480119353
(Cochlear AND (nuclei OR nucleus)),Orbitofrontal,1,5306,2995,8301,0.000120467413565
"Indusium griseum","Lingual gyrus",0,77,254,331,0.0
Entorhinal,"Ventral tegmentum",4,5543,281,5824,0.000686813186813
"Inferior parietal lobule",periaqueductal,0,796,4576,5372,0.0
Fusiform,"Indusium griseum",1,5454,76,5530,0.000180831826401
Entorhinal,("Ventral posterolateral" AND (nuclei OR nucleus)),3,5544,145,5689,0.000527333450519
"Inferior temporal",Prefrontal,225,1486,23876,25362,0.00887154009936
"Inferior temporal",("Ventral anterior" AND (nuclei OR nucleus)),0,1711,237,1948,0.0
("Nucleus cuneatus" OR "cuneate nucleus"),Perirhinal,1,691,1199,1890,0.000529100529101
("Nucleus cuneatus" OR "cuneate nucleus"),("Straight gyrus" OR "gyrus rectus"),0,692,130,822,0.0
"Nucleus basalis",("Ventral posterolateral" AND (nuclei OR nucleus)),1,1846,147,1993,0.000501756146513
"Nucleus basalis","Visual extrastriate",0,1847,1534,3381,0.0
(Inferior AND collicul*),("Ventral posteromedial" AND (nuclei OR nucleus)),2,4281,110,4391,0.000455477112275
"Nucleus basalis","Wernicke's area",0,1847,251,2098,0.0
"Nucleus basalis",("Ventral posterior" AND (nuclei OR nucleus)),1,1846,355,2201,0.000454338936847
("Nucleus gracilis" OR "gracile nucleus"),"Visual cortex",1,373,22879,23252,4.30070531567e-05
"Pontine nuclei",(Raphe AND (nuclei OR nucleus)),86,712,8235,8947,0.00961216050073
"Olfactory bulb",Subgranular,38,11173,594,11767,0.0032293702728
("Locus coeruleus" OR "locus ceruleus"),"Posterior parahippocampal gyrus",0,7639,41,7680,0.0
Orbitofrontal,"Thalamic reticular",2,2994,598,3592,0.000556792873051
Perirhinal,("Straight gyrus" OR "gyrus rectus"),0,1200,130,1330,0.0
(Periventricular AND (nuclei OR nucleus)),Perirhinal,5,2490,1195,3685,0.00135685210312
"Primary sensory",Putamen,11,2999,10738,13737,0.000800757079421
("Straight gyrus" OR "gyrus rectus"),"Zona incerta",0,130,974,1104,0.0
"Posterior parietal",("Ventral posteromedial" AND (nuclei OR nucleus)),1,2153,111,2264,0.000441696113074
"Amygdala",Fusiform,269,23088,5186,28274,0.00951404116856
Ambiguus,("Red nucleus"),21,1195,2355,3550,0.00591549295775
"Anterior cingulate",(Raphe AND (nuclei OR nucleus)),61,5741,8260,14001,0.00435683165488
Cerebellum,("Nucleus gracilis" OR "gracile nucleus"),35,65365,339,65704,0.000532692073542
Cerebellum,"Visual cortex",428,64972,22452,87424,0.00489568081991
"Basal forbrain",(Dorsomedial AND hypothal*),0,1,2139,2140,0.0
Cerebellum,Thalamus,5130,60270,37752,98022,0.0523351900594
Cingulate,Pons,239,10865,25345,36210,0.00660038663353
Cingulate,Orbitofrontal,943,10161,2053,12214,0.0772064843622
(Cochlear AND (nuclei OR nucleus)),"Visual extrastriate",0,5307,1534,6841,0.0
Ambiguus,"Substantia nigra",33,1183,19354,20537,0.00160685591859
"Dorsolateral prefrontal","Interstitial nucleus",0,3004,514,3518,0.0
("Gustatory cortex" OR "gustatory area"),"Posterior parahippocampal gyrus",0,153,41,194,0.0
"Broca's area","Medial frontal",13,681,1582,2263,0.00574458683164
Cingulum,"Visual cortex",8,677,22872,23549,0.000339717185443
"Calcarine fissure","Nucleus accumbens",0,103,12545,12648,0.0
Claustrum,Pineal,248,82493,14155,96648,0.00256601274729
(Cochlear AND (nuclei OR nucleus)),(Periventricular AND (nuclei OR nucleus)),15,5292,2480,7772,0.00193000514668
(Cochlear AND (nuclei OR nucleus)),"Dentate gyrus",31,5276,11412,16688,0.00185762224353
"Calcarine fissure","Visual extrastriate",11,92,1523,1615,0.00681114551084
(Inferior AND collicul*),(Intralaminar AND (nuclei OR nucleus)),41,4242,1059,5301,0.00773438973779
(Inferior AND collicul*),Insula*,35,4248,17138,21386,0.00163658468157
"Inferior parietal lobule",Perirhinal,5,791,1195,1986,0.00251762336354
"Interstitial nucleus",Temporoparietal,0,514,1460,1974,0.0
"Inferior temporal",Infralimbic,1,1710,495,2205,0.000453514739229
"Interstitial nucleus",("Ventral anterior" AND (nuclei OR nucleus)),6,508,231,739,0.00811907983762
Hippocamp*,"Medial geniculate",130,103964,1119,105083,0.0012371173263
"Lingual gyrus",(Septal AND (nuclei OR nucleus)),0,254,4660,4914,0.0
(Inferior AND collicul*),("Ventral anterior" AND (nuclei OR nucleus)),6,4277,231,4508,0.00133096716948
"Olfactory bulb",periaqueductal,66,11145,4510,15655,0.00421590546151
periaqueductal,(Raphe AND (nuclei OR nucleus)),793,3783,7528,11311,0.0701087437008
Perirhinal,periaqueductal,32,1168,4544,5712,0.00560224089636
(Medulla OR "medulla oblongata"),"Stria terminalis",215,50607,2515,53122,0.00404728737623
Operculum,Suprachiasmatic,0,926,6026,6952,0.0
Operculum,"Primary motor",23,903,3182,4085,0.00563035495716
"Olfactory bulb","Superior temporal",4,11207,4103,15310,0.000261267145656
"Paracentral lobule","Superior temporal",7,58,4100,4158,0.0016835016835
Perirhinal,(Superior AND collicul*),24,1176,10060,11236,0.00213599145603
Premotor,"Supplementary motor",762,3967,1599,5566,0.136902623069
Striatum,Subiculum,8862,50078,89379,139457,0.0635464695211
"Posterior parietal","Ventral tegmentum",0,2154,285,2439,0.0
Striatum,"Wernicke's area",1,58939,250,59189,1.68950311713e-05
"Posterior parietal",Temporoparietal,21,2133,1439,3572,0.0058790593505
Temporoparietal,("Ventral posteromedial" AND (nuclei OR nucleus)),0,1460,112,1572,0.0
Subiculum,"Visual cortex",1040,97201,21840,119041,0.00873648574861
Striatum,"Ventromedial prefrontal",0,58940,3,58943,0.0
("Gustatory cortex" OR "gustatory area"),(Medulla OR "medulla oblongata"),11,142,50811,50953,0.000215885227563
Parahippocamp*,"Primary sensory",9,2650,3001,5651,0.00159263847107
("Ventral posterior" AND (nuclei OR nucleus)),"Ventral tegmentum",0,356,285,641,0.0
"Anterior cingulate","Inferior frontal",391,5411,2421,7832,0.0499233912155
"Angular gyrus","Posterior parietal",24,478,2130,2608,0.00920245398773
"Lateral geniculate",("Nucleus gracilis" OR "gracile nucleus"),7,5173,367,5540,0.00126353790614
Cingulate,"Inferior frontal",608,10496,2204,12700,0.047874015748
Cerebellum,("Ventral posterolateral" AND (nuclei OR nucleus)),9,65391,139,65530,0.000137341675568
"Dorsolateral prefrontal",("Locus coeruleus" OR "locus ceruleus"),7,2997,7632,10629,0.00065857559507
("Gustatory cortex" OR "gustatory area"),Precuneus,0,153,1220,1373,0.0
Caudate,Thalamus,3251,15550,39631,55181,0.058915206321
Cingulate,"Superior temporal",620,10484,3487,13971,0.0443776393959
Claustrum,"Nucleus accumbens",8592,74149,3953,78102,0.11000998694
("Centromedian" AND (nuclei OR nucleus)),"Interstitial nucleus",3,213,511,724,0.00414364640884
Hypothalam*,Putamen,952,106597,9797,116394,0.00817911576198
(Inferior AND collicul*),Pulvinar,69,4214,1064,5278,0.0130731337628
(Inferior AND collicul*),"Primary sensory",10,4273,3000,7273,0.00137494843943
"Globus pallidus","Inferior temporal",6,8100,1705,9805,0.000611932687404
Insula*,"Stria terminalis",98,17075,2632,19707,0.00497285228599
("Mammillary body" OR "Mammillary bodies),Orbitofrontal,7,1362,2989,4351,0.00160882555734
("Mammillary body" OR "Mammillary bodies),(Raphe AND (nuclei OR nucleus)),50,1319,8271,9590,0.00521376433785
("Medial dorsal" AND nucl*),Temporoparietal,0,113,1460,1573,0.0
"Nucleus basalis","Posterior parahippocampal gyrus",0,1847,41,1888,0.0
("Medial dorsal" AND nucl*),"Ventromedial prefrontal",0,113,3,116,0.0
(Medulla OR "medulla oblongata"),periaqueductal,746,50076,3830,53906,0.0138389047601
(Medulla OR "medulla oblongata"),Subiculum,1686,49136,96555,145691,0.0115724375562
"Middle temporal",Pineal,2,1635,14401,16036,0.000124719381392
"Pontine nuclei",Subgranular,0,798,632,1430,0.0
Orbitofrontal,Striatum,384,2612,58556,61168,0.0062777923097
"Postcentral gyrus",Thalamus,73,458,42809,43267,0.00168719809555
Orbitofrontal,(Superior AND collicul*),9,2987,10075,13062,0.000689021589343
"Olfactory bulb","Visual cortex",61,11150,22819,33969,0.00179575495305
"Middle frontal",("Straight gyrus" OR "gyrus rectus"),10,1018,120,1138,0.00878734622144
("Superior olive" OR "superior olivary"),Thalamus,102,1155,42780,43935,0.00232161147149
("Red nucleus"),("Superior olive" OR "superior olivary"),17,2359,1240,3599,0.00472353431509
(Raphe AND (nuclei OR nucleus)),("Straight gyrus" OR "gyrus rectus"),3,8318,127,8445,0.000355239786856
"Amygdala","Stria terminalis",1543,21814,1187,23001,0.0670840398244
"Angular gyrus","Middle frontal",37,465,991,1456,0.0254120879121
"Anterior cingulate","Middle temporal",138,5664,1499,7163,0.0192656708083
(Cochlear AND (nuclei OR nucleus)),Temporoparietal,0,5307,1460,6767,0.0
Cerebellum,"Lingual gyrus",53,65347,201,65548,0.000808567767132
(Cochlear AND (nuclei OR nucleus)),"Visual cortex",13,5294,22867,28161,0.000461631334115
("Gustatory cortex" OR "gustatory area"),Insula*,56,97,17117,17214,0.00325316602765
Entorhinal,Perirhinal,576,4971,624,5595,0.102949061662
(Dorsomedial AND hypothal*),"Medial geniculate",12,2127,1237,3364,0.00356718192628
Entorhinal,"Posterior parietal",33,5514,2121,7635,0.00432220039293
"Basal forbrain",Pons,0,1,25584,25585,0.0
("Heschl's gyrus" OR "Transverse temporal"),Insula*,42,1106,17131,18237,0.00230301036355
("Gustatory cortex" OR "gustatory area"),"Inferior parietal lobule",0,153,796,949,0.0
"Basal forbrain",Thalamus,1,0,42881,42881,2.33203516709e-05
"Calcarine fissure","Substantia nigra",0,103,19387,19490,0.0
("Heschl's gyrus" OR "Transverse temporal"),Pineal,3,1145,14400,15545,0.000192988099067
("Centromedian" AND (nuclei OR nucleus)),"Lingual gyrus",0,216,254,470,0.0
Cingulum,"Pontine nuclei",0,685,798,1483,0.0
Hypothalam*,Thalamus,5532,102017,37350,139367,0.0396937582067
Entorhinal,"Supplementary motor",5,5542,2356,7898,0.000633071663712
Hippocamp*,Subiculum,94752,9342,3489,12831,7.38461538462
Hippocamp*,"Interstitial nucleus",17,104077,497,104574,0.000162564308528
"Globus pallidus",("Gustatory cortex" OR "gustatory area"),0,8106,153,8259,0.0
Hippocamp*,Suprachiasmatic,280,103814,5746,109560,0.00255567725447
(Intralaminar AND (nuclei OR nucleus)),("Nucleus gracilis" OR "gracile nucleus"),1,1099,373,1472,0.000679347826087
("Mammillary body" OR "Mammillary bodies),("Red nucleus"),15,15,2364,2379,0.0063051702396
("Locus coeruleus" OR "locus ceruleus"),("Medial dorsal" AND nucl*),1,7638,112,7750,0.000129032258065
("Nucleus gracilis" OR "gracile nucleus"),"Olfactory bulb",5,369,11206,11575,0.000431965442765
("Mammillary body" OR "Mammillary bodies),"Visual cortex",47,47,22855,22902,0.00205222251332
"Olfactory bulb","Paracentral lobule",0,11211,65,11276,0.0
"Medial geniculate","Posterior cingulate",3,1246,1899,3145,0.000953895071542
Infralimbic,Striatum,53,443,58887,59330,0.000893308612843
Insula*,"Paracentral lobule",16,17157,49,17206,0.000929908171568
"Middle temporal","Visual extrastriate",120,1517,1414,2931,0.0409416581372
Orbitofrontal,(Raphe AND (nuclei OR nucleus)),26,2970,8295,11265,0.0023080337328
"Olfactory bulb","Substantia nigra",421,10790,18966,29756,0.014148407044
("Posterior nucleus" AND hypothalamus),"Supplementary motor",0,67,2361,2428,0.0
"Middle frontal",(Periventricular AND (nuclei OR nucleus)),2,1026,2493,3519,0.000568343279341
("Straight gyrus" OR "gyrus rectus"),"Substantia nigra",1,129,19386,19515,5.12426338714e-05
"Primary motor",Subgranular,0,3205,632,3837,0.0
"Middle temporal","Ventromedial prefrontal",0,1637,3,1640,0.0
Striatum,"Thalamic reticular",40,58900,560,59460,0.00067272115708
Precuneus,"Superior frontal",94,1126,997,2123,0.0442769665568
"Superior frontal","Ventromedial prefrontal",0,1091,3,1094,0.0
Precuneus,Subiculum,150,1070,98091,99161,0.00151269148153
Subiculum,("Ventral posterolateral" AND (nuclei OR nucleus)),13,98228,135,98363,0.00013216351677
"Calcarine fissure",Cingulum,0,103,685,788,0.0
(Intralaminar AND (nuclei OR nucleus)),("Ventral posteromedial" AND (nuclei OR nucleus)),5,1095,107,1202,0.00415973377704
Cerebellum,"Posterior parietal",161,65239,1993,67232,0.00239469300333
("Centromedian" AND (nuclei OR nucleus)),"Ventromedial prefrontal",0,216,3,219,0.0
"Lateral geniculate","Postcentral gyrus",0,5180,531,5711,0.0
"Basal forbrain","Interstitial nucleus",0,1,514,515,0.0
"Lateral geniculate",Subgranular,1,5179,631,5810,0.000172117039587
"Dorsolateral prefrontal",Perirhinal,5,2999,1195,4194,0.00119217930377
"Diagonal band of Broca","Medial frontal",4,891,1591,2482,0.00161160354553
Cingulate,Hypothalam*,775,10329,106774,117103,0.00661810542855
"Broca's area","Middle temporal",26,668,1611,2279,0.0114085125055
Cingulate,("Ventral posterior" AND (nuclei OR nucleus)),8,11096,348,11444,0.00069905627403
Cingulum,Prefrontal,85,600,24016,24616,0.00345303867403
Cingulum,Cingulate,115,570,10989,11559,0.00994895752228
"Indusium griseum","Substantia nigra",3,74,19384,19458,0.000154178230034
"Dentate gyrus",("Ventral posterolateral" AND (nuclei OR nucleus)),3,11440,145,11585,0.000258955545965
Claustrum,("Ventral posteromedial" AND (nuclei OR nucleus)),11,82730,101,82831,0.000132800521544
"Indusium griseum",Precuneus,0,77,1220,1297,0.0
"Interstitial nucleus","Nucleus accumbens",16,498,12529,13027,0.00122821831581
"Medial geniculate",Subthalam*,29,1220,4100,5320,0.00545112781955
Parahippocamp*,"Ventromedial prefrontal",0,2659,3,2662,0.0
Infralimbic,"Superior temporal",0,496,4107,4603,0.0
"Olfactory bulb",Pons,320,10891,25264,36155,0.00885078135804
"Olfactory bulb","Pontine nuclei",47,11164,751,11915,0.00394460763743
"Nucleus accumbens","Primary motor",13,12532,3192,15724,0.00082676163826
Orbitofrontal,"Posterior cingulate",134,2862,1768,4630,0.0289416846652
Orbitofrontal,"Ventral tegmentum",2,2994,283,3277,0.000610314311871
"Paracentral lobule",Pineal,0,65,14403,14468,0.0
(Periventricular AND (nuclei OR nucleus)),"Posterior parahippocampal gyrus",0,2495,41,2536,0.0
("Straight gyrus" OR "gyrus rectus"),Temporoparietal,0,130,1460,1590,0.0
"Substantia nigra",Suprachiasmatic,73,19314,5953,25267,0.00288914394269
"Substantia nigra","Superior temporal",17,19370,4090,23460,0.000724637681159
Subthalam*,(Superior AND collicul*),127,4002,9957,13959,0.00909807292786
("Medial dorsal" AND nucl*),"Superior frontal",0,113,1091,1204,0.0
(Inferior AND collicul*),Thalamus,831,3452,42051,45503,0.0182625321407
"Angular gyrus",Cingulate,100,402,11004,11406,0.00876731544801
Cerebellum,Subiculum,8597,56803,89644,146447,0.0587038314202
("Centromedian" AND (nuclei OR nucleus)),"Primary auditory",0,216,1869,2085,0.0
("Centromedian" AND (nuclei OR nucleus)),("Ventral posteromedial" AND (nuclei OR nucleus)),1,215,111,326,0.00306748466258
"Dorsolateral prefrontal",Thalamus,270,2734,42612,45346,0.00595421867419
("Gustatory cortex" OR "gustatory area"),"Inferior temporal",1,152,1710,1862,0.000537056928034
"Dorsolateral prefrontal","Nucleus basalis",3,3001,1844,4845,0.00061919504644
("Gustatory cortex" OR "gustatory area"),("Mammillary body" OR "Mammillary bodies),1,152,1,153,0.00653594771242
"Basal forbrain",Perirhinal,0,1,1200,1201,0.0
"Broca's area","Visual cortex",27,667,22853,23520,0.00114795918367
Cingulate,(Raphe AND (nuclei OR nucleus)),191,10913,8130,19043,0.0100299322586
Hypothalam*,Prefrontal,1027,106522,23074,129596,0.00792462730331
("Inferior olive" OR "Inferior olivary"),("Locus coeruleus" OR "locus ceruleus"),150,2230,7489,9719,0.0154336865933
("Mammillary body" OR "Mammillary bodies),("Ventral posteromedial" AND (nuclei OR nucleus)),2,2,112,114,0.0175438596491
Parahippocamp*,"Postcentral gyrus",35,2624,496,3120,0.0112179487179
Insula*,"Thalamic reticular",9,17164,591,17755,0.000506899464939
periaqueductal,"Superior temporal",14,4562,4093,8655,0.00161756210283
("Nucleus gracilis" OR "gracile nucleus"),"Zona incerta",8,366,966,1332,0.00600600600601
"Medial geniculate","Posterior parietal",4,1245,2150,3395,0.00117820324006
Insula*,("Mammillary body" OR "Mammillary bodies),12,17161,1357,18518,0.000648018144508
"Pontine nuclei",("Ventral posterior" AND (nuclei OR nucleus)),5,793,351,1144,0.00437062937063
("Locus coeruleus" OR "locus ceruleus"),(Raphe AND (nuclei OR nucleus)),1431,6208,6890,13098,0.109253321118
Operculum,Perirhinal,6,920,1194,2114,0.00283822138127
"Nucleus accumbens",Orbitofrontal,146,12399,2850,15249,0.0095743983212
"Nucleus basalis","Postcentral gyrus",0,1847,531,2378,0.0
("Posterior nucleus" AND hypothalamus),("Straight gyrus" OR "gyrus rectus"),0,67,130,197,0.0
"Primary auditory",("Superior olive" OR "superior olivary"),20,1849,1237,3086,0.00648088139987
"Primary motor",("Straight gyrus" OR "gyrus rectus"),0,3205,130,3335,0.0
"Piriform cortex",Premotor,3,1740,4726,6466,0.000463965357253
"Stria terminalis","Wernicke's area",0,2730,251,2981,0.0
(Superior AND collicul*),"Wernicke's area",0,10084,251,10335,0.0
Operculum,("Ventral posteromedial" AND (nuclei OR nucleus)),1,925,111,1036,0.000965250965251
Pineal,"Posterior parahippocampal gyrus",0,14403,41,14444,0.0
Striatum,"Visual cortex",420,58520,22460,80980,0.00518646579402
Striatum,("Ventral anterior" AND (nuclei OR nucleus)),78,58862,159,59021,0.00132156351129
"Middle temporal","Pontine nuclei",7,1630,791,2421,0.00289136720363
"Superior frontal","Wernicke's area",2,1089,249,1338,0.00149476831091
("Red nucleus"),Subiculum,211,2165,98030,100195,0.00210589350766
"Anterior cingulate",Entorhinal,103,5699,5444,11143,0.00924347123755
"Basal forbrain","Broca's area",0,1,694,695,0.0
Cingulate,Fusiform,286,10818,5169,15987,0.0178895352474
"Lateral geniculate",("Ventral anterior" AND (nuclei OR nucleus)),13,5167,224,5391,0.00241142645149
("Centromedian" AND (nuclei OR nucleus)),"Superior frontal",0,216,1091,1307,0.0
Entorhinal,Pons,63,5484,25521,31005,0.00203193033382
Entorhinal,("Gustatory cortex" OR "gustatory area"),3,5544,150,5694,0.000526870389884
Entorhinal,(Septal AND (nuclei OR nucleus)),171,5376,4489,9865,0.0173340091232
"Basal forbrain",("Ventral posterolateral" AND (nuclei OR nucleus)),0,1,148,149,0.0
"Broca's area","Posterior parahippocampal gyrus",0,694,41,735,0.0
"Broca's area","Pontine nuclei",1,693,797,1490,0.000671140939597
Cingulate,"Primary auditory",38,11066,1831,12897,0.00294642164845
Caudate,"Pontine nuclei",67,18734,731,19465,0.00344207552016
Caudate,Pons,555,18246,25029,43275,0.0128249566724
Cingulate,"Ventral tegmentum",13,11091,272,11363,0.00114406406759
"Dentate gyrus","Indusium griseum",10,11433,67,11500,0.000869565217391
Cingulum,"Thalamic reticular",0,685,600,1285,0.0
Hypothalam*,("Red nucleus"),232,107317,2144,109461,0.00211947634317
Claustrum,Suprachiasmatic,161,82580,5865,88445,0.0018203403245
"Indusium griseum",Subiculum,43,34,98198,98232,0.000437739229579
(Cochlear AND (nuclei OR nucleus)),Pulvinar,1,5306,1132,6438,0.000155327741535
"Indusium griseum",("Red nucleus"),0,77,2376,2453,0.0
Fusiform,("Superior olive" OR "superior olivary"),26,5429,1231,6660,0.0039039039039
("Inferior olive" OR "Inferior olivary"),"Pontine nuclei",137,2243,661,2904,0.0471763085399
("Inferior olive" OR "Inferior olivary"),"Stria terminalis",28,2352,2702,5054,0.00554016620499
"Lingual gyrus","Thalamic reticular",0,254,600,854,0.0
(Intralaminar AND (nuclei OR nucleus)),("Locus coeruleus" OR "locus ceruleus"),46,1054,7593,8647,0.00531976408003
("Medial dorsal" AND nucl*),Thalamus,85,28,42797,42825,0.0019848219498
"Inferior frontal",Prefrontal,722,2090,23379,25469,0.0283481879932
"Medial geniculate",("Ventral posterolateral" AND (nuclei OR nucleus)),9,1240,139,1379,0.0065264684554
Parahippocamp*,(Raphe AND (nuclei OR nucleus)),15,2644,8306,10950,0.0013698630137
"Medial frontal",Operculum,12,1583,914,2497,0.0048057669203
Pons,"Zona incerta",100,25484,874,26358,0.00379391456104
"Postcentral gyrus",("Straight gyrus" OR "gyrus rectus"),1,530,129,659,0.00151745068285
("Locus coeruleus" OR "locus ceruleus"),Subiculum,1140,6499,97101,103600,0.0110038610039
"Olfactory bulb","Ventromedial prefrontal",0,11211,3,11214,0.0
Orbitofrontal,"Piriform cortex",44,2952,1699,4651,0.00946033111159
("Posterior nucleus" AND hypothalamus),"Thalamic reticular",1,66,599,665,0.0015037593985
"Middle frontal",(Medulla OR "medulla oblongata"),2,1026,50820,51846,3.8575782124e-05
(Periventricular AND (nuclei OR nucleus)),"Wernicke's area",0,2495,251,2746,0.0
"Middle frontal","Middle temporal",126,902,1511,2413,0.0522171570659
"Primary auditory",("Ventral posterior" AND (nuclei OR nucleus)),3,1866,353,2219,0.0013519603425
("Superior olive" OR "superior olivary"),"Supplementary motor",0,1257,2361,3618,0.0
Striatum,"Zona incerta",92,58848,882,59730,0.00154026452369
Precuneus,Subthalam*,6,1214,4123,5337,0.00112422709387
Pulvinar,("Ventral posterior" AND (nuclei OR nucleus)),21,1112,335,1447,0.0145127850726
Prefrontal,"Primary motor",303,23798,2902,26700,0.0113483146067
Cingulum,(Periventricular AND (nuclei OR nucleus)),10,675,2485,3160,0.00316455696203
("Ventral posteromedial" AND (nuclei OR nucleus)),"Visual extrastriate",0,112,1534,1646,0.0
Putamen,"Thalamic reticular",13,10736,587,11323,0.00114810562572
"Amygdala","Posterior parietal",71,23286,2083,25369,0.00279869131617
"Amygdala",Premotor,91,23266,4638,27904,0.00326118119266
"Angular gyrus",Operculum,11,491,915,1406,0.00782361308677
"Angular gyrus",Pineal,0,502,14403,14905,0.0
"Basal forbrain","Indusium griseum",0,1,77,78,0.0
"Basal forbrain","Lateral geniculate",0,1,5180,5181,0.0
(Cochlear AND (nuclei OR nucleus)),Subgranular,1,5306,631,5937,0.000168435236652
(Cochlear AND (nuclei OR nucleus)),"Substantia nigra",63,5244,19324,24568,0.00256431129925
Fusiform,(Intralaminar AND (nuclei OR nucleus)),4,5451,1096,6547,0.000610966855048
"Lateral geniculate","Wernicke's area",0,5180,251,5431,0.0
(Dorsomedial AND hypothal*),Insula*,50,2089,17123,19212,0.00260254007912
Entorhinal,Prefrontal,289,5258,23812,29070,0.00994152046784
("Gustatory cortex" OR "gustatory area"),"Medial frontal",0,153,1595,1748,0.0
Entorhinal,("Locus coeruleus" OR "locus ceruleus"),100,5447,7539,12986,0.00770060064685
"Broca's area","Nucleus basalis",0,694,1847,2541,0.0
"Broca's area",("Ventral anterior" AND (nuclei OR nucleus)),0,694,237,931,0.0
Cingulate,"Superior frontal",335,10769,756,11525,0.0290672451193
("Gustatory cortex" OR "gustatory area"),("Ventral posteromedial" AND (nuclei OR nucleus)),1,152,111,263,0.00380228136882
Claustrum,"Posterior parahippocampal gyrus",5,82736,36,82772,6.04069008844e-05
(Cochlear AND (nuclei OR nucleus)),Hippocamp*,132,5175,103962,109137,0.0012094889909
"Dentate gyrus",Thalamus,527,10916,42355,53271,0.00989281222429
Fusiform,Infralimbic,0,5455,496,5951,0.0
("Inferior olive" OR "Inferior olivary"),("Superior olive" OR "superior olivary"),35,2345,1222,3567,0.00981216708719
(Inferior AND collicul*),"Primary motor",3,4280,3202,7482,0.000400962309543
("Inferior olive" OR "Inferior olivary"),Pulvinar,6,2374,1127,3501,0.00171379605827
Insula*,("Superior olive" OR "superior olivary"),1,17172,1256,18428,5.42652485348e-05
"Nucleus basalis",(Raphe AND (nuclei OR nucleus)),83,1764,8238,10002,0.00829834033193
("Locus coeruleus" OR "locus ceruleus"),"Olfactory bulb",263,7376,10948,18324,0.0143527614058
"Inferior frontal",("Locus coeruleus" OR "locus ceruleus"),4,2808,7635,10443,0.000383031695873
"Medial geniculate","Visual extrastriate",2,1247,1532,2779,0.000719683339331
periaqueductal,Temporoparietal,0,4576,1460,6036,0.0
"Medial geniculate","Stria terminalis",27,1222,2703,3925,0.00687898089172
Operculum,Temporoparietal,8,918,1452,2370,0.00337552742616
"Primary sensory","Superior temporal",23,2987,4084,7071,0.00325272238722
(Periventricular AND (nuclei OR nucleus)),Suprachiasmatic,324,2171,5702,7873,0.0411533087768
("Ventral posteromedial" AND (nuclei OR nucleus)),("Ventral posterolateral" AND (nuclei OR nucleus)),31,81,117,198,0.156565656566
"Primary motor","Supplementary motor",591,2614,1770,4384,0.134808394161
"Substantia nigra","Thalamic reticular",28,19359,572,19931,0.00140484672119
"Amygdala",("Heschl's gyrus" OR "Transverse temporal"),16,23341,1132,24473,0.000653781718629
"Amygdala","Middle temporal",82,23275,1555,24830,0.0033024567056
"Amygdala","Ventromedial prefrontal",1,23356,2,23358,4.28118845792e-05
"Angular gyrus",Hypothalam*,2,500,107547,108047,1.85104630392e-05
"Anterior cingulate",Cingulum,41,5761,644,6405,0.0064012490242
Cerebellum,("Ventral posterior" AND (nuclei OR nucleus)),32,65368,324,65692,0.00048712171954
"Calcarine fissure","Lingual gyrus",2,101,252,353,0.0056657223796
"Lateral geniculate","Nucleus basalis",8,5172,1839,7011,0.00114106404222
Cerebellum,Prefrontal,1224,64176,22877,87053,0.0140603999862
"Lateral geniculate",Suprachiasmatic,195,4985,5831,10816,0.0180288461538
Fusiform,"Medial frontal",63,5392,1532,6924,0.00909878682842
"Dorsolateral prefrontal","Primary sensory",3,3001,3007,6008,0.000499334221039
"Diagonal band of Broca",Infralimbic,7,888,489,1377,0.00508351488744
"Globus pallidus",("Red nucleus"),256,7850,2120,9970,0.0256770310933
"Basal forbrain","Medial geniculate",0,1,1249,1250,0.0
Entorhinal,"Posterior cingulate",72,5475,1830,7305,0.00985626283368
"Globus pallidus","Visual cortex",51,8055,22829,30884,0.00165134049994
"Broca's area",(Dorsomedial AND hypothal*),1,693,2138,2831,0.000353232073472
("Centromedian" AND (nuclei OR nucleus)),("Locus coeruleus" OR "locus ceruleus"),10,206,7629,7835,0.00127632418634
Cingulum,("Ventral posterior" AND (nuclei OR nucleus)),1,684,355,1039,0.000962463907603
Caudate,(Raphe AND (nuclei OR nucleus)),380,18421,7941,26362,0.0144146878082
Claustrum,"Supplementary motor",376,82365,1985,84350,0.00445761707172
Claustrum,Thalamus,8318,74423,34564,108987,0.0763210291136
Claustrum,"Inferior parietal lobule",54,82687,742,83429,0.000647256949023
Cingulum,"Zona incerta",2,683,972,1655,0.0012084592145
"Indusium griseum","Medial frontal",0,77,1595,1672,0.0
Cingulum,"Postcentral gyrus",5,680,526,1206,0.00414593698176
"Dentate gyrus",("Red nucleus"),62,11381,2314,13695,0.00452719970792
Fusiform,Entorhinal,37,5418,5510,10928,0.00338579795022
Fusiform,("Ventral anterior" AND (nuclei OR nucleus)),3,5452,234,5686,0.000527611677805
"Inferior parietal lobule",(Raphe AND (nuclei OR nucleus)),3,793,8318,9111,0.000329272308199
"Inferior temporal","Postcentral gyrus",26,1685,505,2190,0.0118721461187
Insula*,("Ventral posterior" AND (nuclei OR nucleus)),9,17164,347,17511,0.000513962652047
("Nucleus cuneatus" OR "cuneate nucleus"),("Ventral posterior" AND (nuclei OR nucleus)),2,690,354,1044,0.00191570881226
("Mammillary body" OR "Mammillary bodies),"Posterior parietal",6,6,2153,2159,0.00277906438166
("Medial dorsal" AND nucl*),("Ventral anterior" AND (nuclei OR nucleus)),7,106,230,336,0.0208333333333
Parahippocamp*,Perirhinal,285,2374,915,3289,0.0866524779568
periaqueductal,Parahippocamp*,13,4563,2646,7209,0.00180330142877
("Locus coeruleus" OR "locus ceruleus"),Precuneus,1,7638,1219,8857,0.000112905046856
Operculum,("Superior olive" OR "superior olivary"),0,926,1257,2183,0.0
"Paracentral lobule","Visual extrastriate",0,65,1534,1599,0.0
"Primary sensory",(Septal AND (nuclei OR nucleus)),4,3006,4656,7662,0.000522056904203
(Periventricular AND (nuclei OR nucleus)),("Ventral posterolateral" AND (nuclei OR nucleus)),0,2495,148,2643,0.0
Pineal,(Raphe AND (nuclei OR nucleus)),82,14321,8239,22560,0.00363475177305
"Primary auditory",Thalamus,211,1658,42671,44329,0.00475986374608
Subthalam*,"Wernicke's area",0,4129,251,4380,0.0
"Posterior parahippocampal gyrus","Wernicke's area",0,41,251,292,0.0
"Superior frontal","Supplementary motor",68,1023,2293,3316,0.0205066344994
Pineal,Premotor,1,14402,4728,19130,5.22739153163e-05
("Red nucleus"),("Ventral posterior" AND (nuclei OR nucleus)),4,2372,352,2724,0.0014684287812
(Septal AND (nuclei OR nucleus)),"Superior frontal",0,4660,1091,5751,0.0
Subgranular,("Ventral posterolateral" AND (nuclei OR nucleus)),0,632,148,780,0.0
"Anterior cingulate","Wernicke's area",11,5791,240,6031,0.00182390979937
"Lingual gyrus",("Mammillary body" OR "Mammillary bodies),1,253,1,254,0.00393700787402
"Dorsolateral prefrontal","Postcentral gyrus",14,2990,517,3507,0.00399201596806
Fusiform,"Posterior parietal",34,5421,2120,7541,0.00450868585068
"Calcarine fissure",Orbitofrontal,1,102,2995,3097,0.000322893122376
"Basal forbrain","Primary auditory",0,1,1869,1870,0.0
"Calcarine fissure",("Ventral posterior" AND (nuclei OR nucleus)),0,103,356,459,0.0
Cingulum,Precuneus,17,668,1203,1871,0.00908605024051
("Centromedian" AND (nuclei OR nucleus)),"Paracentral lobule",0,216,65,281,0.0
"Indusium griseum","Piriform cortex",6,71,1737,1808,0.0033185840708
"Indusium griseum",("Nucleus cuneatus" OR "cuneate nucleus"),0,77,692,769,0.0
"Indusium griseum",Pons,3,74,25581,25655,0.000116936269733
"Inferior parietal lobule",Precuneus,86,710,1134,1844,0.0466377440347
("Inferior olive" OR "Inferior olivary"),(Intralaminar AND (nuclei OR nucleus)),12,2368,1088,3456,0.00347222222222
"Interstitial nucleus","Superior frontal",0,514,1091,1605,0.0
"Lingual gyrus",Subgranular,0,254,632,886,0.0
"Inferior frontal",("Nucleus gracilis" OR "gracile nucleus"),0,2812,374,3186,0.0
"Medial frontal","Middle temporal",70,1525,1567,3092,0.022639068564
"Medial frontal","Nucleus basalis",6,1589,1841,3430,0.00174927113703
(Inferior AND collicul*),Subthalam*,53,4230,4076,8306,0.00638092944859
"Inferior frontal","Olfactory bulb",5,2807,11206,14013,0.000356811532149
"Medial geniculate",("Ventral posterior" AND (nuclei OR nucleus)),33,1216,323,1539,0.0214424951267
"Nucleus basalis",("Ventral posteromedial" AND (nuclei OR nucleus)),0,1847,112,1959,0.0
"Inferior frontal",("Straight gyrus" OR "gyrus rectus"),12,2800,118,2918,0.00411240575737
"Medial geniculate","Wernicke's area",1,1248,250,1498,0.000667556742323
"Inferior frontal","Inferior parietal lobule",147,2665,649,3314,0.0443572721786
Insula*,(Medulla OR "medulla oblongata"),142,17031,50680,67711,0.00209714817386
(Medulla OR "medulla oblongata"),Precuneus,1,50821,1219,52040,1.92159877018e-05
"Pontine nuclei",Putamen,71,727,10678,11405,0.00622533976326
"Postcentral gyrus",Prefrontal,47,484,24054,24538,0.00191539652783
Insula*,("Posterior nucleus" AND hypothalamus),3,17170,64,17234,0.000174074503888
("Posterior nucleus" AND hypothalamus),("Ventral anterior" AND (nuclei OR nucleus)),0,67,237,304,0.0
(Superior AND collicul*),"Visual cortex",1243,8841,21637,30478,0.0407835159787
Prefrontal,Temporoparietal,126,23975,1334,25309,0.00497846615828
"Medial geniculate",("Ventral posterior" AND (nuclei OR nucleus)),33,1216,323,1539,0.0214424951267
"Amygdala",Temporoparietal,31,23326,1429,24755,0.00125227226823
("Centromedian" AND (nuclei OR nucleus)),Suprachiasmatic,1,215,6025,6240,0.000160256410256
"Lingual gyrus","Lateral geniculate",0,254,5180,5434,0.0
"Diagonal band of Broca","Visual cortex",9,886,22871,23757,0.00037883571158
"Diagonal band of Broca","Dorsolateral prefrontal",0,895,3004,3899,0.0
"Diagonal band of Broca","Inferior frontal",0,895,2812,3707,0.0
"Diagonal band of Broca",Parahippocamp*,1,894,2658,3552,0.000281531531532
(Dorsomedial AND hypothal*),"Zona incerta",117,2022,857,2879,0.0406391108024
"Amygdala","Calcarine fissure",0,23357,103,23460,0.0
"Broca's area","Dorsolateral prefrontal",40,654,2964,3618,0.0110558319514
Caudate,("Mammillary body" OR "Mammillary bodies),59,18742,1310,20052,0.00294234989029
Caudate,("Medial dorsal" AND nucl*),14,18787,99,18886,0.000741289844329
Cingulate,"Supplementary motor",576,10528,1785,12313,0.0467798262
Cingulum,"Substantia nigra",7,678,19380,20058,0.000348987934989
Hypothalam*,Striatum,5037,102512,53903,156415,0.0322027938497
Hypothalam*,"Middle frontal",9,107540,1019,108559,8.29042271944e-05
(Inferior AND collicul*),"Nucleus accumbens",81,4202,12464,16666,0.00486019440778
"Dentate gyrus",("Locus coeruleus" OR "locus ceruleus"),158,11285,7481,18766,0.00841948204199
"Interstitial nucleus",("Posterior nucleus" AND hypothalamus),0,514,67,581,0.0
Insula*,("Ventral posteromedial" AND (nuclei OR nucleus)),5,17168,107,17275,0.000289435600579
"Lingual gyrus","Pontine nuclei",0,254,798,1052,0.0
("Medial dorsal" AND nucl*),"Middle temporal",1,112,1636,1748,0.000572082379863
("Mammillary body" OR "Mammillary bodies),("Posterior nucleus" AND hypothalamus),125,125,64,189,0.661375661376
"Medial frontal","Middle frontal",73,1522,955,2477,0.0294711344368
"Inferior frontal",Orbitofrontal,127,2685,2869,5554,0.0228664025927
("Medial dorsal" AND nucl*),"Substantia nigra",6,107,19381,19488,0.000307881773399
Parahippocamp*,"Primary auditory",4,2655,1865,4520,0.000884955752212
Infralimbic,Pons,23,473,25561,26034,0.000883460090651
(Medulla OR "medulla oblongata"),"Nucleus accumbens",166,50656,12379,63035,0.00263345760292
"Postcentral gyrus",Premotor,33,498,4696,5194,0.00635348479014
"Nucleus basalis",("Nucleus cuneatus" OR "cuneate nucleus"),0,1847,692,2539,0.0
Orbitofrontal,(Septal AND (nuclei OR nucleus)),14,2982,4646,7628,0.00183534347142
"Posterior parahippocampal gyrus",("Red nucleus"),0,41,2376,2417,0.0
"Primary sensory","Visual cortex",124,2886,22756,25642,0.00483581623898
"Middle temporal","Primary motor",14,1623,3191,4814,0.00290818446199
Subthalam*,"Visual cortex",15,4114,22865,26979,0.000555987990659
Suprachiasmatic,"Zona incerta",60,5966,914,6880,0.00872093023256
Subthalam*,("Ventral posterolateral" AND (nuclei OR nucleus)),4,4125,144,4269,0.000936987584914
Ambiguus,Cingulum,0,1216,685,1901,0.0
"Anterior cingulate","Visual extrastriate",27,5775,1507,7282,0.00370777258995
"Calcarine fissure",Insula*,2,101,17171,17272,0.000115794349236
"Calcarine fissure","Middle frontal",0,103,1028,1131,0.0
"Lateral geniculate","Substantia nigra",99,5081,19288,24369,0.00406253847101
("Centromedian" AND (nuclei OR nucleus)),Precuneus,0,216,1220,1436,0.0
(Dorsomedial AND hypothal*),Orbitofrontal,11,2128,2985,5113,0.00215137883826
"Dorsolateral prefrontal",Prefrontal,3004,0,21097,21097,0.142389913258
("Heschl's gyrus" OR "Transverse temporal"),"Ventromedial prefrontal",0,1148,3,1151,0.0
("Centromedian" AND (nuclei OR nucleus)),Entorhinal,4,212,5543,5755,0.000695047784535
Fusiform,Putamen,50,5405,10699,16104,0.00310481867859
Claustrum,"Nucleus basalis",1068,81673,779,82452,0.012952990831
("Heschl's gyrus" OR "Transverse temporal"),Precuneus,5,1143,1215,2358,0.00212044105174
Cingulum,"Posterior parietal",5,680,2149,2829,0.00176740897844
"Broca's area",("Superior olive" OR "superior olivary"),0,694,1257,1951,0.0
"Dentate gyrus","Primary motor",10,11433,3195,14628,0.000683620453924
(Cochlear AND (nuclei OR nucleus)),"Lingual gyrus",0,5307,254,5561,0.0
(Inferior AND collicul*),Orbitofrontal,2,4281,2994,7275,0.000274914089347
Hypothalam*,("Posterior nucleus" AND hypothalamus),61,107488,6,107494,0.000567473533407
Entorhinal,"Wernicke's area",1,5546,250,5796,0.000172532781228
"Inferior frontal",("Ventral anterior" AND (nuclei OR nucleus)),0,2812,237,3049,0.0
("Inferior olive" OR "Inferior olivary"),"Primary motor",11,2369,3194,5563,0.00197735035053
"Inferior parietal lobule",("Straight gyrus" OR "gyrus rectus"),0,796,130,926,0.0
(Intralaminar AND (nuclei OR nucleus)),"Middle frontal",0,1100,1028,2128,0.0
"Interstitial nucleus","Posterior parietal",1,513,2153,2666,0.000375093773443
("Mammillary body" OR "Mammillary bodies),Subgranular,1,1368,631,1999,0.000500250125063
("Mammillary body" OR "Mammillary bodies),"Primary sensory",3,3,3010,3013,0.000995685363425
("Medial dorsal" AND nucl*),"Thalamic reticular",2,111,598,709,0.00282087447109
("Medial dorsal" AND nucl*),Subgranular,0,113,632,745,0.0
"Medial frontal","Zona incerta",2,1593,972,2565,0.000779727095517
Infralimbic,(Septal AND (nuclei OR nucleus)),42,454,4618,5072,0.00828075709779
Insula*,(Intralaminar AND (nuclei OR nucleus)),44,17129,1056,18185,0.0024195765741
Insula*,("Locus coeruleus" OR "locus ceruleus"),71,17102,7568,24670,0.00287798946088
Operculum,("Ventral posterolateral" AND (nuclei OR nucleus)),0,926,148,1074,0.0
"Olfactory bulb","Supplementary motor",1,11210,2360,13570,7.36919675755e-05
("Posterior nucleus" AND hypothalamus),("Ventral posterior" AND (nuclei OR nucleus)),3,64,353,417,0.00719424460432
Pons,("Straight gyrus" OR "gyrus rectus"),4,25580,126,25706,0.000155605695168
"Middle frontal",Pineal,0,1028,14403,15431,0.0
"Middle temporal",Subthalam*,1,1636,4128,5764,0.000173490631506
"Stria terminalis","Superior frontal",0,2730,1091,3821,0.0
"Posterior parahippocampal gyrus",("Ventral posterolateral" AND (nuclei OR nucleus)),0,41,148,189,0.0
Precuneus,Prefrontal,449,771,23652,24423,0.0183843098718
"Supplementary motor","Ventral tegmentum",0,2361,285,2646,0.0
"Supplementary motor","Visual cortex",60,2301,22820,25121,0.00238843995064
"Supplementary motor","Zona incerta",4,2357,970,3327,0.00120228434025
"Ventromedial prefrontal","Wernicke's area",0,3,251,254,0.0
"Primary motor",("Ventral posterior" AND (nuclei OR nucleus)),8,3197,348,3545,0.00225669957687
("Ventral posterior" AND (nuclei OR nucleus)),("Ventral posteromedial" AND (nuclei OR nucleus)),3,353,109,462,0.00649350649351
Subiculum,Thalamus,5949,92292,36933,129225,0.0460359837493
"Medial geniculate",("Nucleus cuneatus" OR "cuneate nucleus"),7,1242,685,1927,0.00363258951738
Ambiguus,"Lingual gyrus",0,1216,254,1470,0.0
Ambiguus,"Primary auditory",0,1216,1869,3085,0.0
Cerebellum,"Paracentral lobule",11,65389,54,65443,0.000168085203918
(Intralaminar AND (nuclei OR nucleus)),Striatum,241,859,58699,59558,0.00404647570436
(Intralaminar AND (nuclei OR nucleus)),("Posterior nucleus" AND hypothalamus),3,1097,64,1161,0.00258397932817
Cerebellum,("Gustatory cortex" OR "gustatory area"),4,65396,149,65545,6.10267754977e-05
"Dorsolateral prefrontal",Precuneus,100,2904,1120,4024,0.0248508946322
"Dorsolateral prefrontal",Entorhinal,14,2990,5533,8523,0.00164261410302
"Broca's area",Premotor,119,575,4610,5185,0.0229508196721
"Calcarine fissure","Pontine nuclei",1,102,797,899,0.00111234705228
Caudate,"Primary motor",58,18743,3147,21890,0.00264961169484
Caudate,"Medial frontal",71,18730,1524,20254,0.00350548039893
Caudate,"Postcentral gyrus",24,18777,507,19284,0.00124455507156
Cingulate,Thalamus,1923,9181,40959,50140,0.0383526126845
(Inferior AND collicul*),"Middle temporal",14,4269,1623,5892,0.00237610319077
Fusiform,("Heschl's gyrus" OR "Transverse temporal"),8,5447,1140,6587,0.00121451343555
Fusiform,"Thalamic reticular",10,5445,590,6035,0.0016570008285
"Globus pallidus",Parahippocamp*,22,8084,2637,10721,0.00205204738364
Hypothalam*,("Ventral posterolateral" AND (nuclei OR nucleus)),9,107540,139,107679,8.35817568885e-05
"Inferior parietal lobule",Striatum,19,777,58921,59698,0.000318268618714
"Inferior parietal lobule","Superior temporal",186,610,3921,4531,0.0410505407195
"Inferior temporal","Primary sensory",8,1703,3002,4705,0.00170031880978
"Indusium griseum","Thalamic reticular",0,77,600,677,0.0
(Inferior AND collicul*),Pineal,30,4253,14373,18626,0.00161065177709
("Mammillary body" OR "Mammillary bodies),"Primary motor",2,2,3205,3207,0.000623635796695
("Mammillary body" OR "Mammillary bodies),"Middle temporal",41,41,1635,1676,0.0244630071599
"Lingual gyrus",("Nucleus gracilis" OR "gracile nucleus"),0,254,374,628,0.0
("Mammillary body" OR "Mammillary bodies),"Superior temporal",16,16,4102,4118,0.00388538125304
("Locus coeruleus" OR "locus ceruleus"),"Visual cortex",79,7560,22801,30361,0.00260202233128
"Nucleus basalis",("Superior olive" OR "superior olivary"),1,1846,1256,3102,0.000322372662798
("Mammillary body" OR "Mammillary bodies),"Visual extrastriate",0,0,1534,1534,0.0
periaqueductal,Perirhinal,32,4544,1168,5712,0.00560224089636
Infralimbic,"Supplementary motor",1,495,2360,2855,0.000350262697023
("Locus coeruleus" OR "locus ceruleus"),"Pontine nuclei",83,7556,715,8271,0.0100350622657
Operculum,"Posterior parahippocampal gyrus",0,926,41,967,0.0
Pons,("Posterior nucleus" AND hypothalamus),6,25578,61,25639,0.000234018487461
Orbitofrontal,"Zona incerta",2,2994,972,3966,0.000504286434695
"Posterior parahippocampal gyrus","Primary motor",0,41,3205,3246,0.0
"Primary sensory","Thalamic reticular",9,3001,591,3592,0.00250556792873
Perirhinal,("Ventral anterior" AND (nuclei OR nucleus)),1,1199,236,1435,0.000696864111498
Thalamus,("Ventral posteromedial" AND (nuclei OR nucleus)),88,42794,24,42818,0.00205521042552
"Primary motor","Superior temporal",44,3161,4063,7224,0.00609080841639
Suprachiasmatic,("Ventral posterior" AND (nuclei OR nucleus)),0,6026,356,6382,0.0
"Angular gyrus","Posterior cingulate",50,452,1852,2304,0.0217013888889
(Intralaminar AND (nuclei OR nucleus)),"Posterior parietal",17,1083,2137,3220,0.00527950310559
"Anterior cingulate",Temporoparietal,52,5750,1408,7158,0.00726459905001
"Lateral geniculate","Paracentral lobule",0,5180,65,5245,0.0
(Intralaminar AND (nuclei OR nucleus)),Subiculum,76,1024,98165,99189,0.000766213995504
"Diagonal band of Broca",Fusiform,10,885,5445,6330,0.00157977883096
(Dorsomedial AND hypothal*),"Superior temporal",8,2131,4099,6230,0.00128410914928
"Diagonal band of Broca","Middle frontal",1,894,1027,1921,0.000520562207184
"Lateral geniculate",("Ventral posterolateral" AND (nuclei OR nucleus)),4,5176,144,5320,0.000751879699248
"Globus pallidus",("Superior olive" OR "superior olivary"),15,8091,1242,9333,0.00160720025715
"Amygdala",Ambiguus,41,23316,1175,24491,0.00167408435752
Cingulate,(Septal AND (nuclei OR nucleus)),157,10947,4503,15450,0.0101618122977
Cingulate,(Superior AND collicul*),122,10982,9962,20944,0.00582505729565
Cingulum,("Ventral posterolateral" AND (nuclei OR nucleus)),1,684,147,831,0.00120336943442
Cingulum,Perirhinal,2,683,1198,1881,0.00106326422116
Claustrum,("Nucleus cuneatus" OR "cuneate nucleus"),23,82718,669,83387,0.000275822370393
Cingulate,"Wernicke's area",20,11084,231,11315,0.00176756517897
(Cochlear AND (nuclei OR nucleus)),Premotor,11,5296,4718,10014,0.00109846215299
Hypothalam*,"Primary sensory",48,107501,2962,110463,0.000434534640558
("Inferior olive" OR "Inferior olivary"),("Ventral anterior" AND (nuclei OR nucleus)),2,2378,235,2613,0.000765403750478
("Mammillary body" OR "Mammillary bodies),Pulvinar,7,1362,1126,2488,0.00281350482315
(Inferior AND collicul*),"Thalamic reticular",16,4267,584,4851,0.00329828901257
"Inferior frontal",Parahippocamp*,147,2665,2512,5177,0.0283948232567
("Mammillary body" OR "Mammillary bodies),"Substantia nigra",82,82,19305,19387,0.0042296384175
"Inferior temporal","Visual cortex",230,1481,22650,24131,0.00953130827566
Parahippocamp*,("Posterior nucleus" AND hypothalamus),1,2658,66,2724,0.000367107195301
Infralimbic,"Primary auditory",1,495,1868,2363,0.000423190859077
"Medial geniculate","Primary sensory",17,1232,2993,4225,0.00402366863905
"Middle frontal",Subiculum,99,929,98142,99071,0.000999283342249
(Medulla OR "medulla oblongata"),Parahippocamp*,15,50807,2644,53451,0.000280630858169
Insula*,"Lingual gyrus",52,17121,202,17323,0.00300178952837
"Pontine nuclei","Visual cortex",72,726,22808,23534,0.00305940341633
"Olfactory bulb",Putamen,296,10915,10453,21368,0.0138524897042
Operculum,(Septal AND (nuclei OR nucleus)),0,926,4660,5586,0.0
"Pontine nuclei","Wernicke's area",0,798,251,1049,0.0
"Medial frontal","Thalamic reticular",2,1593,598,2191,0.000912825193975
Premotor,"Visual extrastriate",50,4679,1484,6163,0.00811293201363
Perirhinal,Subgranular,0,1200,632,1832,0.0
Pineal,"Visual cortex",11,14392,22869,37261,0.000295214835887
Precuneus,"Primary sensory",11,1209,2999,4208,0.00261406844106
"Piriform cortex","Primary sensory",8,1735,3002,4737,0.00168883259447
Pons,"Substantia nigra",889,24695,18498,43193,0.0205820387563
(Superior AND collicul*),"Visual extrastriate",58,10026,1476,11502,0.00504260128673
Pulvinar,Putamen,54,1079,10695,11774,0.00458637676236
("Ventral posteromedial" AND (nuclei OR nucleus)),"Zona incerta",6,106,968,1074,0.00558659217877
Ambiguus,Claustrum,41,1175,82700,83875,0.000488822652757
"Amygdala","Medial geniculate",138,23219,1111,24330,0.00567200986436
Ambiguus,"Inferior parietal lobule",0,1216,796,2012,0.0
"Amygdala",(Superior AND collicul*),303,23054,9781,32835,0.00922795797168
Cerebellum,("Medial dorsal" AND nucl*),8,65392,105,65497,0.000122142998916
"Anterior cingulate",("Ventral posterolateral" AND (nuclei OR nucleus)),1,5801,147,5948,0.000168123739072
Cingulate,Insula*,1958,9146,15215,24361,0.0803743688683
Cingulate,"Dorsolateral prefrontal",821,10283,2183,12466,0.0658591368522
"Dorsolateral prefrontal",("Ventral posterolateral" AND (nuclei OR nucleus)),0,3004,148,3152,0.0
"Diagonal band of Broca",("Nucleus cuneatus" OR "cuneate nucleus"),3,892,689,1581,0.00189753320683
("Gustatory cortex" OR "gustatory area"),"Posterior parietal",1,152,2153,2305,0.000433839479393
Caudate,"Interstitial nucleus",20,18781,494,19275,0.00103761348898
("Heschl's gyrus" OR "Transverse temporal"),(Superior AND collicul*),9,1139,10075,11214,0.000802568218299
Claustrum,"Superior temporal",292,82449,3815,86264,0.00338495780395
Hypothalam*,"Nucleus accumbens",1499,106050,11046,117096,0.0128014620482
"Indusium griseum",Striatum,7,70,58933,59003,0.000118638035354
("Inferior olive" OR "Inferior olivary"),Temporoparietal,0,2380,1460,3840,0.0
"Inferior temporal","Posterior cingulate",60,1651,1842,3493,0.017177211566
"Inferior parietal lobule",("Red nucleus"),2,794,2374,3168,0.000631313131313
"Inferior parietal lobule",("Medial dorsal" AND nucl*),0,796,113,909,0.0
Hippocamp*,"Supplementary motor",63,104031,2298,106329,0.000592500634822
"Lingual gyrus",("Ventral posteromedial" AND (nuclei OR nucleus)),0,254,112,366,0.0
Hippocamp*,"Wernicke's area",7,104087,244,104331,6.70941522654e-05
"Lingual gyrus","Primary sensory",1,253,3009,3262,0.000306560392397
("Medial dorsal" AND nucl*),("Ventral posterior" AND (nuclei OR nucleus)),10,103,346,449,0.022271714922
("Mammillary body" OR "Mammillary bodies),"Piriform cortex",14,14,1730,1744,0.00802752293578
periaqueductal,"Zona incerta",115,4461,859,5320,0.0216165413534
Pons,"Wernicke's area",1,25583,250,25833,3.87101769055e-05
"Middle temporal",("Nucleus gracilis" OR "gracile nucleus"),2,1635,372,2007,0.000996512207275
"Nucleus accumbens","Zona incerta",60,12485,914,13399,0.00447794611538
"Olfactory bulb",Striatum,1121,10090,57819,67909,0.0165073848827
Infralimbic,"Visual extrastriate",0,496,1534,2030,0.0
"Olfactory bulb",Premotor,3,11208,4726,15934,0.000188276641145
("Posterior nucleus" AND hypothalamus),"Postcentral gyrus",0,67,531,598,0.0
"Posterior cingulate","Ventral tegmentum",1,1901,284,2185,0.00045766590389
"Middle frontal","Pontine nuclei",1,1027,797,1824,0.000548245614035
"Middle temporal",Subiculum,151,1486,98090,99576,0.00151642966177
(Septal AND (nuclei OR nucleus)),Subgranular,5,4655,627,5282,0.000946611132147
"Primary motor",Subthalam*,48,3157,4081,7238,0.00663166620613
"Posterior parietal","Wernicke's area",4,2150,247,2397,0.00166875260743
"Posterior parietal",Subgranular,0,2154,632,2786,0.0
"Supplementary motor","Superior temporal",126,2235,3981,6216,0.0202702702703
"Middle frontal","Primary auditory",4,1024,1865,2889,0.00138456213223
Pulvinar,"Supplementary motor",10,1123,2351,3474,0.00287852619459
Ambiguus,"Amygdala",41,1175,23316,24491,0.00167408435752
"Amygdala","Wernicke's area",3,23354,248,23602,0.000127107872214
"Anterior cingulate","Piriform cortex",24,5778,1719,7497,0.0032012805122
"Anterior cingulate","Globus pallidus",73,5729,8033,13762,0.00530446156082
"Anterior cingulate",Claustrum,873,4929,81868,86797,0.0100579513117
("Centromedian" AND (nuclei OR nucleus)),(Periventricular AND (nuclei OR nucleus)),4,212,2491,2703,0.00147983721791
(Cochlear AND (nuclei OR nucleus)),(Superior AND collicul*),369,4938,9715,14653,0.0251825564731
"Anterior cingulate",("Superior olive" OR "superior olivary"),1,5801,1256,7057,0.000141703273346
Cerebellum,Precuneus,183,65217,1037,66254,0.0027620973828
("Centromedian" AND (nuclei OR nucleus)),("Ventral anterior" AND (nuclei OR nucleus)),15,201,222,423,0.0354609929078
"Diagonal band of Broca",("Medial dorsal" AND nucl*),0,895,113,1008,0.0
Fusiform,"Pontine nuclei",5,5450,793,6243,0.000800897004645
"Calcarine fissure",Pineal,0,103,14403,14506,0.0
"Basal forbrain","Stria terminalis",0,1,2730,2731,0.0
("Heschl's gyrus" OR "Transverse temporal"),("Inferior olive" OR "Inferior olivary"),2,1146,2378,3524,0.000567536889898
"Calcarine fissure",Pulvinar,3,100,1130,1230,0.00243902439024
"Globus pallidus",Subthalam*,1185,6921,2944,9865,0.120121642169
("Heschl's gyrus" OR "Transverse temporal"),("Mammillary body" OR "Mammillary bodies),1,1147,0,1147,0.000871839581517
Caudate,(Medulla OR "medulla oblongata"),635,18166,50187,68353,0.00929000921686
Cingulum,periaqueductal,4,681,4572,5253,0.000761469636398
("Gustatory cortex" OR "gustatory area"),(Septal AND (nuclei OR nucleus)),2,151,4658,4809,0.000415886878769
Cingulate,"Ventromedial prefrontal",0,11104,3,11107,0.0
Claustrum,"Ventral tegmentum",64,82677,221,82898,0.000772033100919
(Cochlear AND (nuclei OR nucleus)),"Indusium griseum",1,5306,76,5382,0.000185804533631
Hypothalam*,(Periventricular AND (nuclei OR nucleus)),1868,105681,627,106308,0.0175715844527
"Dentate gyrus",Pulvinar,3,11440,1130,12570,0.000238663484487
"Indusium griseum",(Inferior AND collicul*),2,75,4281,4356,0.000459136822773
"Inferior parietal lobule","Olfactory bulb",1,795,11210,12005,8.32986255727e-05
Fusiform,Hypothalam*,93,5362,107456,112818,0.000824336542041
("Inferior olive" OR "Inferior olivary"),"Inferior temporal",2,2378,1709,4087,0.000489356496207
"Inferior temporal","Medial geniculate",1,1710,1248,2958,0.000338066260987
"Lingual gyrus","Nucleus basalis",0,254,1847,2101,0.0
Insula*,"Visual extrastriate",29,17144,1505,18649,0.00155504316585
"Lingual gyrus",("Ventral anterior" AND (nuclei OR nucleus)),0,254,237,491,0.0
"Medial frontal","Medial geniculate",0,1595,1249,2844,0.0
("Nucleus gracilis" OR "gracile nucleus"),Pineal,1,373,14402,14775,6.76818950931e-05
"Medial geniculate",Suprachiasmatic,21,1228,6005,7233,0.00290335960182
Infralimbic,"Zona incerta",10,486,964,1450,0.00689655172414
"Medial frontal","Postcentral gyrus",22,1573,509,2082,0.0105667627281
("Red nucleus"),"Visual cortex",19,2357,22861,25218,0.000753430089619
"Stria terminalis",("Ventral posteromedial" AND (nuclei OR nucleus)),3,2727,109,2836,0.00105782792666
(Septal AND (nuclei OR nucleus)),Temporoparietal,0,4660,1460,6120,0.0
Suprachiasmatic,("Ventral posteromedial" AND (nuclei OR nucleus)),0,6026,112,6138,0.0
Infralimbic,"Nucleus basalis",2,494,1845,2339,0.000855066267636
"Lingual gyrus",Putamen,14,240,10735,10975,0.00127562642369
Prefrontal,("Ventral posteromedial" AND (nuclei OR nucleus)),1,24100,111,24211,4.13035397134e-05
Subiculum,Suprachiasmatic,263,97978,5763,103741,0.0025351596765
Ambiguus,(Cochlear AND (nuclei OR nucleus)),18,1198,5289,6487,0.00277478032989
Ambiguus,"Dorsolateral prefrontal",1,1215,3003,4218,0.000237079184448
"Amygdala","Primary motor",26,23331,3179,26510,0.000980761976613
"Angular gyrus","Amygdala",13,489,23344,23833,0.000545462174296
"Angular gyrus",("Mammillary body" OR "Mammillary bodies),0,502,0,502,0.0
"Broca's area","Zona incerta",0,694,974,1668,0.0
"Angular gyrus","Middle temporal",47,455,1590,2045,0.0229828850856
(Intralaminar AND (nuclei OR nucleus)),"Zona incerta",74,1026,900,1926,0.0384215991693
Cingulate,(Medulla OR "medulla oblongata"),112,10992,50710,61702,0.00181517616933
Cingulate,"Paracentral lobule",28,11076,37,11113,0.00251957167282
("Centromedian" AND (nuclei OR nucleus)),Putamen,24,192,10725,10917,0.00219840615554
"Diagonal band of Broca",(Medulla OR "medulla oblongata"),38,857,50784,51641,0.000735849421971
"Globus pallidus",Thalamus,2138,5968,40744,46712,0.0457698235999
"Broca's area",("Medial dorsal" AND nucl*),0,694,113,807,0.0
"Broca's area",("Mammillary body" OR "Mammillary bodies),0,694,60,754,0.0
"Broca's area",("Ventral posteromedial" AND (nuclei OR nucleus)),0,694,112,806,0.0
Caudate,"Posterior parietal",59,18742,2095,20837,0.00283150165571
Cingulum,"Middle frontal",9,676,1019,1695,0.00530973451327
"Dentate gyrus","Substantia nigra",309,11134,19078,30212,0.0102277240831
Hypothalam*,"Olfactory bulb",1489,106060,9722,115782,0.0128603755333
(Cochlear AND (nuclei OR nucleus)),("Inferior olive" OR "Inferior olivary"),47,5260,2333,7593,0.00618991176083
("Inferior olive" OR "Inferior olivary"),"Superior frontal",1,2379,1090,3469,0.000288267512251
"Globus pallidus",(Intralaminar AND (nuclei OR nucleus)),57,8049,1043,9092,0.00626924769028
"Indusium griseum",Prefrontal,3,74,24098,24172,0.000124110541122
(Inferior AND collicul*),"Interstitial nucleus",38,4245,476,4721,0.0080491421309
"Inferior parietal lobule","Thalamic reticular",0,796,600,1396,0.0
Hippocamp*,"Inferior temporal",251,103843,1460,105303,0.00238359780823
("Inferior olive" OR "Inferior olivary"),"Medial frontal",1,2379,1594,3973,0.000251698968034
Hippocamp*,("Mammillary body" OR "Mammillary bodies),417,103677,952,104629,0.00398551070927
("Nucleus gracilis" OR "gracile nucleus"),"Stria terminalis",6,368,2724,3092,0.0019404915912
"Medial geniculate",("Posterior nucleus" AND hypothalamus),4,1245,63,1308,0.00305810397554
"Inferior frontal","Middle temporal",305,2507,1332,3839,0.0794477728575
Parahippocamp*,Subgranular,1,2658,631,3289,0.000304043782305
"Nucleus accumbens","Thalamic reticular",5,12540,595,13135,0.000380662352493
"Olfactory bulb","Primary auditory",0,11211,1869,13080,0.0
Operculum,"Ventral tegmentum",0,926,285,1211,0.0
"Paracentral lobule","Piriform cortex",0,65,1743,1808,0.0
"Paracentral lobule","Supplementary motor",10,55,2351,2406,0.00415627597672
"Paracentral lobule",Parahippocamp*,4,61,2655,2716,0.00147275405007
"Medial frontal",("Straight gyrus" OR "gyrus rectus"),5,1590,125,1715,0.00291545189504
"Primary sensory",Striatum,45,2965,58895,61860,0.000727449078565
"Superior frontal",("Ventral posterior" AND (nuclei OR nucleus)),0,1091,356,1447,0.0
Suprachiasmatic,Temporoparietal,0,6026,1460,7486,0.0
"Amygdala",Hypothalam*,5763,17594,101786,119380,0.0482744178254
"Angular gyrus",Entorhinal,4,498,5543,6041,0.000662142029465
"Anterior cingulate",Subgranular,0,5802,632,6434,0.0
("Centromedian" AND (nuclei OR nucleus)),"Posterior cingulate",0,216,1902,2118,0.0
(Intralaminar AND (nuclei OR nucleus)),Putamen,58,1042,10691,11733,0.00494332225347
("Centromedian" AND (nuclei OR nucleus)),(Superior AND collicul*),12,204,10072,10276,0.00116776956014
"Diagonal band of Broca","Wernicke's area",0,895,251,1146,0.0
Entorhinal,(Periventricular AND (nuclei OR nucleus)),25,5522,2470,7992,0.00312812812813
("Gustatory cortex" OR "gustatory area"),("Posterior nucleus" AND hypothalamus),0,153,67,220,0.0
("Heschl's gyrus" OR "Transverse temporal"),Infralimbic,0,1148,496,1644,0.0
Caudate,"Stria terminalis",206,18595,2524,21119,0.00975424972773
("Heschl's gyrus" OR "Transverse temporal"),("Ventral posteromedial" AND (nuclei OR nucleus)),0,1148,112,1260,0.0
("Centromedian" AND (nuclei OR nucleus)),"Middle frontal",0,216,1028,1244,0.0
"Indusium griseum",("Medial dorsal" AND nucl*),0,77,113,190,0.0
"Indusium griseum","Middle frontal",0,77,1028,1105,0.0
"Dentate gyrus","Piriform cortex",259,11184,1484,12668,0.020445216293
"Dentate gyrus",(Medulla OR "medulla oblongata"),95,11348,50727,62075,0.00153040676601
(Cochlear AND (nuclei OR nucleus)),"Middle frontal",0,5307,1028,6335,0.0
Fusiform,Suprachiasmatic,7,5448,6019,11467,0.000610447370716
Fusiform,"Interstitial nucleus",13,5442,501,5943,0.00218744741713
("Inferior olive" OR "Inferior olivary"),("Red nucleus"),169,2211,2207,4418,0.0382526029878
Hippocamp*,"Inferior parietal lobule",96,103998,700,104698,0.000916922959369
"Inferior parietal lobule","Middle temporal",100,696,1537,2233,0.0447828034035
Insula*,"Ventral tegmentum",10,17163,275,17438,0.000573460259204
("Nucleus cuneatus" OR "cuneate nucleus"),Pineal,1,691,14402,15093,6.62558802094e-05
"Medial geniculate",Operculum,1,1248,925,2173,0.000460193281178
"Olfactory bulb",Operculum,1,11210,925,12135,8.2406262876e-05
periaqueductal,Striatum,212,4364,58728,63092,0.00336017244659
Infralimbic,"Substantia nigra",21,475,19366,19841,0.00105841439444
(Medulla OR "medulla oblongata"),"Primary auditory",23,50799,1846,52645,0.000436888593409
"Olfactory bulb",("Ventral posterior" AND (nuclei OR nucleus)),3,11208,353,11561,0.000259493123432
Pons,"Posterior parahippocampal gyrus",2,25582,39,25621,7.80609656141e-05
Orbitofrontal,"Posterior parietal",49,2947,2105,5052,0.0096991290578
"Paracentral lobule",("Superior olive" OR "superior olivary"),0,65,1257,1322,0.0
"Nucleus basalis",Pons,82,1765,25502,27267,0.00300729819929
"Primary auditory","Primary motor",15,1854,3190,5044,0.00297383029342
Precuneus,Premotor,97,1123,4632,5755,0.016854908775
Suprachiasmatic,"Visual extrastriate",0,6026,1534,7560,0.0
"Primary motor","Visual cortex",111,3094,22769,25863,0.00429184549356
("Superior olive" OR "superior olivary"),("Ventral posterolateral" AND (nuclei OR nucleus)),0,1257,148,1405,0.0
Subgranular,"Thalamic reticular",0,632,600,1232,0.0
Subgranular,"Superior temporal",0,632,4107,4739,0.0
Ambiguus,"Interstitial nucleus",10,1206,504,1710,0.00584795321637
"Angular gyrus",("Superior olive" OR "superior olivary"),0,502,1257,1759,0.0
"Angular gyrus",Pulvinar,2,500,1131,1631,0.00122624156959
(Intralaminar AND (nuclei OR nucleus)),"Visual extrastriate",9,1091,1525,2616,0.00344036697248
Cerebellum,"Dentate gyrus",778,64622,10665,75287,0.010333789366
"Basal forbrain","Lingual gyrus",0,1,254,255,0.0
"Lateral geniculate",Subthalam*,36,5144,4093,9237,0.00389736927574
("Centromedian" AND (nuclei OR nucleus)),"Supplementary motor",1,215,2360,2575,0.000388349514563
Fusiform,"Lateral geniculate",33,5422,5147,10569,0.0031223389157
"Diagonal band of Broca",Pulvinar,2,893,1131,2024,0.00098814229249
(Dorsomedial AND hypothal*),"Visual cortex",5,2134,22875,25009,0.000199928025911
Cingulate,("Superior olive" OR "superior olivary"),5,11099,1252,12351,0.000404825520201
"Dentate gyrus",("Nucleus cuneatus" OR "cuneate nucleus"),6,11437,686,12123,0.000494926998268
Hypothalam*,(Superior AND collicul*),701,106848,9383,116231,0.00603109325395
("Inferior olive" OR "Inferior olivary"),Subgranular,0,2380,632,3012,0.0
"Interstitial nucleus",("Nucleus gracilis" OR "gracile nucleus"),3,511,371,882,0.00340136054422
"Inferior temporal",Temporoparietal,19,1692,1441,3133,0.00606447494414
"Interstitial nucleus",("Medial dorsal" AND nucl*),2,512,111,623,0.00321027287319
"Interstitial nucleus",Putamen,13,501,10736,11237,0.00115689240901
("Nucleus cuneatus" OR "cuneate nucleus"),(Periventricular AND (nuclei OR nucleus)),10,682,2485,3167,0.00315756236186
("Nucleus cuneatus" OR "cuneate nucleus"),"Zona incerta",12,680,962,1642,0.00730816077954
"Inferior parietal lobule",("Inferior olive" OR "Inferior olivary"),1,795,2379,3174,0.000315059861374
("Medial dorsal" AND nucl*),("Straight gyrus" OR "gyrus rectus"),1,112,129,241,0.00414937759336
Parahippocamp*,"Wernicke's area",4,2655,247,2902,0.0013783597519
("Nucleus gracilis" OR "gracile nucleus"),"Wernicke's area",0,374,251,625,0.0
periaqueductal,("Ventral posterior" AND (nuclei OR nucleus)),9,4567,347,4914,0.0018315018315
"Nucleus accumbens",("Superior olive" OR "superior olivary"),13,12532,1244,13776,0.000943670150987
"Nucleus basalis",(Periventricular AND (nuclei OR nucleus)),11,1836,2484,4320,0.0025462962963
Operculum,Subgranular,0,926,632,1558,0.0
"Paracentral lobule",Thalamus,7,58,42875,42933,0.000163044744136
Perirhinal,Temporoparietal,1,1199,1459,2658,0.000376222723853
(Periventricular AND (nuclei OR nucleus)),Temporoparietal,0,2495,1460,3955,0.0
Premotor,"Primary motor",680,4049,2525,6574,0.103437785214
("Superior olive" OR "superior olivary"),"Zona incerta",10,1247,964,2211,0.00452284034374
"Primary motor","Superior frontal",36,3169,1055,4224,0.00852272727273
Suprachiasmatic,"Ventral tegmentum",2,6024,283,6307,0.000317107975266
"Thalamic reticular",Temporoparietal,0,600,1460,2060,0.0
Prefrontal,Suprachiasmatic,29,24072,5997,30069,0.000964448435266
Prefrontal,Striatum,2703,21398,56237,77635,0.0348167707864
Ambiguus,"Middle temporal",0,1216,1637,2853,0.0
Ambiguus,Pulvinar,0,1216,1133,2349,0.0
"Amygdala","Substantia nigra",1013,22344,18374,40718,0.024878432143
"Angular gyrus",(Superior AND collicul*),3,499,10081,10580,0.000283553875236
"Anterior cingulate","Superior temporal",339,5463,3768,9231,0.036724081898
"Anterior cingulate",Cingulate,5802,0,5302,5302,1.09430403621
"Basal forbrain",(Inferior AND collicul*),0,1,4283,4284,0.0
(Cochlear AND (nuclei OR nucleus)),Putamen,32,5275,10717,15992,0.00200100050025
"Basal forbrain",Hypothalam*,0,1,107549,107550,0.0
(Intralaminar AND (nuclei OR nucleus)),"Substantia nigra",109,991,19278,20269,0.00537767033401
Cerebellum,"Inferior frontal",266,65134,2546,67680,0.00393026004728
"Diagonal band of Broca",("Mammillary body" OR "Mammillary bodies),30,865,31,896,0.0334821428571
"Diagonal band of Broca","Nucleus basalis",108,787,1739,2526,0.0427553444181
Cingulate,("Gustatory cortex" OR "gustatory area"),9,11095,144,11239,0.00080078298781
Entorhinal,("Inferior olive" OR "Inferior olivary"),22,5525,2358,7883,0.00279081567931
"Globus pallidus",Subgranular,1,8105,631,8736,0.000114468864469
Entorhinal,"Lingual gyrus",0,5547,254,5801,0.0
("Gustatory cortex" OR "gustatory area"),Perirhinal,4,149,1196,1345,0.00297397769517
"Calcarine fissure","Primary auditory",2,101,1867,1968,0.0010162601626
Caudate,"Lateral geniculate",71,18730,5109,23839,0.00297831284869
("Heschl's gyrus" OR "Transverse temporal"),"Supplementary motor",13,1135,2348,3483,0.00373241458513
Caudate,"Olfactory bulb",417,18384,10794,29178,0.0142915895538
"Dentate gyrus",Hypothalam*,690,10753,106859,117612,0.00586674829099
Caudate,"Ventral tegmentum",37,18764,248,19012,0.00194613928045
Hypothalam*,("Mammillary body" OR "Mammillary bodies),567,106982,802,107784,0.00526052104208
Hypothalam*,Subgranular,12,107537,620,108157,0.000110949822943
(Inferior AND collicul*),("Posterior nucleus" AND hypothalamus),2,4281,65,4346,0.000460193281178
Fusiform,"Inferior frontal",234,5221,2578,7799,0.030003846647
(Inferior AND collicul*),"Paracentral lobule",0,4283,65,4348,0.0
"Inferior parietal lobule","Superior frontal",47,749,1044,1793,0.0262130507529
"Inferior temporal",periaqueductal,4,1707,4572,6279,0.000637044115305
(Intralaminar AND (nuclei OR nucleus)),Parahippocamp*,9,1091,2650,3741,0.00240577385726
"Inferior frontal","Medial frontal",146,2666,1449,4115,0.0354799513973
"Interstitial nucleus",(Septal AND (nuclei OR nucleus)),19,495,4641,5136,0.00369937694704
("Nucleus cuneatus" OR "cuneate nucleus"),"Nucleus basalis",0,692,1847,2539,0.0
("Nucleus gracilis" OR "gracile nucleus"),Thalamus,54,320,42828,43148,0.00125150644294
("Nucleus cuneatus" OR "cuneate nucleus"),"Thalamic reticular",1,691,599,1290,0.00077519379845
Infralimbic,"Ventromedial prefrontal",0,496,3,499,0.0
Insula*,Perirhinal,159,17014,1041,18055,0.00880642481307
"Olfactory bulb",Prefrontal,100,11111,24001,35112,0.00284802916382
("Posterior nucleus" AND hypothalamus),Temporoparietal,0,67,1460,1527,0.0
Pons,"Primary sensory",31,25553,2979,28532,0.00108649936913
Pons,Prefrontal,258,25326,23843,49169,0.00524720860705
"Primary sensory","Primary motor",96,2914,3109,6023,0.01593890088
"Posterior parahippocampal gyrus","Stria terminalis",0,41,2730,2771,0.0
("Red nucleus"),"Supplementary motor",11,2365,2350,4715,0.00233297985154
Pineal,Precuneus,1,14402,1219,15621,6.40163881954e-05
"Middle temporal","Primary auditory",17,1620,1852,3472,0.00489631336406
Premotor,("Ventral posteromedial" AND (nuclei OR nucleus)),1,4728,111,4839,0.000206654267411
Ambiguus,"Inferior frontal",0,1216,2812,4028,0.0
"Calcarine fissure",Cerebellum,3,100,65397,65497,4.58036245935e-05
"Angular gyrus","Inferior frontal",81,421,2731,3152,0.0256979695431
"Anterior cingulate","Dorsolateral prefrontal",622,5180,2382,7562,0.0822533721238
"Anterior cingulate",Operculum,78,5724,848,6572,0.011868533171
"Basal forbrain",Claustrum,0,1,82741,82742,0.0
"Lateral geniculate",("Red nucleus"),15,5165,2361,7526,0.00199309061919
"Dorsolateral prefrontal","Inferior frontal",154,2850,2658,5508,0.0279593318809
(Dorsomedial AND hypothal*),"Medial frontal",2,2137,1593,3730,0.000536193029491
"Diagonal band of Broca",("Superior olive" OR "superior olivary"),4,891,1253,2144,0.00186567164179
"Globus pallidus",("Straight gyrus" OR "gyrus rectus"),1,8105,129,8234,0.00012144765606
Fusiform,"Primary auditory",11,5444,1858,7302,0.00150643659271
"Basal forbrain",(Periventricular AND (nuclei OR nucleus)),0,1,2495,2496,0.0
("Gustatory cortex" OR "gustatory area"),"Middle temporal",0,153,1637,1790,0.0
Ambiguus,"Ventromedial prefrontal",0,1216,3,1219,0.0
("Centromedian" AND (nuclei OR nucleus)),("Gustatory cortex" OR "gustatory area"),0,216,153,369,0.0
("Gustatory cortex" OR "gustatory area"),Pulvinar,0,153,1133,1286,0.0
Cingulum,(Septal AND (nuclei OR nucleus)),23,662,4637,5299,0.00434044159275
"Indusium griseum",("Nucleus gracilis" OR "gracile nucleus"),0,77,374,451,0.0
"Globus pallidus","Middle frontal",7,8099,1021,9120,0.000767543859649
("Inferior olive" OR "Inferior olivary"),Prefrontal,10,2370,24091,26461,0.000377914666868
Hippocamp*,("Heschl's gyrus" OR "Transverse temporal"),81,104013,1067,105080,0.000770841263799
("Nucleus gracilis" OR "gracile nucleus"),Pons,27,347,25557,25904,0.00104231006794
"Inferior frontal",(Raphe AND (nuclei OR nucleus)),0,2812,8321,11133,0.0
periaqueductal,Subgranular,0,4576,632,5208,0.0
Insula*,(Periventricular AND (nuclei OR nucleus)),23,17150,2472,19622,0.00117215370502
"Nucleus accumbens",(Periventricular AND (nuclei OR nucleus)),122,12423,2373,14796,0.00824547174912
"Olfactory bulb","Stria terminalis",178,11033,2552,13585,0.0131026867869
"Medial frontal","Supplementary motor",105,1490,2256,3746,0.0280298985585
Orbitofrontal,(Periventricular AND (nuclei OR nucleus)),8,2988,2487,5475,0.00146118721461
"Paracentral lobule","Thalamic reticular",0,65,600,665,0.0
Orbitofrontal,Putamen,113,2883,10636,13519,0.0083586064058
"Primary sensory","Stria terminalis",1,3009,2729,5738,0.000174276751481
Pineal,"Primary sensory",4,14399,3006,17405,0.000229819017524
("Red nucleus"),("Ventral anterior" AND (nuclei OR nucleus)),9,2367,228,2595,0.00346820809249
"Piriform cortex",("Posterior nucleus" AND hypothalamus),0,1743,67,1810,0.0
Pineal,("Ventral posterior" AND (nuclei OR nucleus)),1,14402,355,14757,6.77644507691e-05
("Superior olive" OR "superior olivary"),"Ventral tegmentum",0,1257,285,1542,0.0
("Ventral posterior" AND (nuclei OR nucleus)),("Ventral posterolateral" AND (nuclei OR nucleus)),2,354,146,500,0.004
Subiculum,"Ventromedial prefrontal",0,98241,3,98244,0.0
periaqueductal,"Posterior parietal",9,4567,2145,6712,0.00134088200238
Ambiguus,(Medulla OR "medulla oblongata"),635,581,50187,50768,0.0125078789789
(Intralaminar AND (nuclei OR nucleus)),"Visual cortex",61,1039,22819,23858,0.00255679436667
Cerebellum,Suprachiasmatic,112,65288,5914,71202,0.00157298952277
Cerebellum,Cingulate,1033,64367,10071,74438,0.0138773207233
Cerebellum,(Cochlear AND (nuclei OR nucleus)),314,65086,4993,70079,0.00448065754363
(Dorsomedial AND hypothal*),"Nucleus accumbens",128,2011,12417,14428,0.00887163848073
Cerebellum,"Medial geniculate",75,65325,1174,66499,0.00112783650882
"Basal forbrain",(Raphe AND (nuclei OR nucleus)),1,0,8320,8320,0.000120192307692
"Broca's area","Nucleus accumbens",1,693,12544,13237,7.55458185389e-05
Entorhinal,"Medial geniculate",17,5530,1232,6762,0.0025140490979
Cingulate,"Primary motor",271,10833,2934,13767,0.0196847533958
("Gustatory cortex" OR "gustatory area"),(Superior AND collicul*),1,152,10083,10235,9.77039570103e-05
(Cochlear AND (nuclei OR nucleus)),"Interstitial nucleus",13,5294,501,5795,0.00224331320104
Claustrum,Prefrontal,3931,78810,20170,98980,0.0397150939584
("Gustatory cortex" OR "gustatory area"),"Primary auditory",0,153,1869,2022,0.0
Cingulum,("Ventral anterior" AND (nuclei OR nucleus)),0,685,237,922,0.0
Hypothalam*,"Pontine nuclei",105,107444,693,108137,0.000970990502788
"Inferior frontal","Superior temporal",619,2193,3488,5681,0.108959690195
"Indusium griseum",Premotor,0,77,4729,4806,0.0
"Lingual gyrus",("Medial dorsal" AND nucl*),0,254,113,367,0.0
"Dentate gyrus",Parahippocamp*,158,11285,2501,13786,0.0114609023647
"Inferior temporal",(Raphe AND (nuclei OR nucleus)),6,1705,8315,10020,0.00059880239521
"Lingual gyrus",Prefrontal,55,199,24046,24245,0.00226850897092
("Nucleus cuneatus" OR "cuneate nucleus"),Operculum,0,692,926,1618,0.0
("Nucleus cuneatus" OR "cuneate nucleus"),"Supplementary motor",1,691,2360,3051,0.000327761389708
("Mammillary body" OR "Mammillary bodies),"Pontine nuclei",52,52,791,843,0.061684460261
("Mammillary body" OR "Mammillary bodies),periaqueductal,45,1324,4531,5855,0.00768573868488
("Mammillary body" OR "Mammillary bodies),"Ventromedial prefrontal",1,1,3,4,0.25
(Intralaminar AND (nuclei OR nucleus)),"Olfactory bulb",16,1084,11195,12279,0.00130303770665
("Nucleus gracilis" OR "gracile nucleus"),Subiculum,10,364,98231,98595,0.000101425021553
"Nucleus basalis","Olfactory bulb",38,1809,11173,12982,0.00292712987213
"Medial frontal",Thalamus,163,1432,42719,44151,0.00369187560871
"Postcentral gyrus",Pulvinar,2,529,1131,1660,0.00120481927711
Orbitofrontal,("Straight gyrus" OR "gyrus rectus"),34,2962,96,3058,0.0111183780249
"Posterior parietal",("Ventral posterior" AND (nuclei OR nucleus)),3,2151,353,2504,0.00119808306709
("Superior olive" OR "superior olivary"),Temporoparietal,0,1257,1460,2717,0.0
"Stria terminalis","Zona incerta",109,2621,865,3486,0.0312679288583
Thalamus,"Visual extrastriate",150,42732,1384,44116,0.00340012693807
(Raphe AND (nuclei OR nucleus)),"Visual cortex",63,8258,22817,31075,0.0020273531778
Subiculum,("Superior olive" OR "superior olivary"),50,98191,1207,99398,0.000503028229944
"Amygdala",(Inferior AND collicul*),180,23177,4103,27280,0.00659824046921
Ambiguus,"Anterior cingulate",5,1211,5797,7008,0.000713470319635
Ambiguus,Perirhinal,2,1214,1198,2412,0.000829187396352
Ambiguus,"Globus pallidus",9,1207,8097,9304,0.000967325881341
"Amygdala",Suprachiasmatic,258,23099,5768,28867,0.00893754113694
"Angular gyrus",("Gustatory cortex" OR "gustatory area"),0,502,153,655,0.0
"Calcarine fissure","Medial geniculate",0,103,1249,1352,0.0
"Basal forbrain","Inferior parietal lobule",0,1,796,797,0.0
"Diagonal band of Broca",Pons,40,855,25544,26399,0.00151520890943
("Centromedian" AND (nuclei OR nucleus)),(Septal AND (nuclei OR nucleus)),4,212,4656,4868,0.000821692686935
"Diagonal band of Broca","Inferior parietal lobule",0,895,796,1691,0.0
(Cochlear AND (nuclei OR nucleus)),("Ventral posterolateral" AND (nuclei OR nucleus)),0,5307,148,5455,0.0
"Dorsolateral prefrontal",Pineal,1,3003,14402,17405,5.74547543809e-05
"Basal forbrain","Posterior parahippocampal gyrus",0,1,41,42,0.0
"Amygdala",("Centromedian" AND (nuclei OR nucleus)),16,23341,200,23541,0.000679665264857
"Basal forbrain",("Straight gyrus" OR "gyrus rectus"),0,1,130,131,0.0
"Globus pallidus",Temporoparietal,2,8104,1458,9562,0.000209161263334
("Heschl's gyrus" OR "Transverse temporal"),"Superior temporal",159,989,3948,4937,0.0322057929917
Cingulum,(Dorsomedial AND hypothal*),4,681,2135,2816,0.00142045454545
Hippocamp*,"Indusium griseum",50,104044,27,104071,0.000480441237232
("Heschl's gyrus" OR "Transverse temporal"),"Pontine nuclei",0,1148,798,1946,0.0
Cingulum,"Lateral geniculate",2,683,5178,5861,0.000341238696468
("Gustatory cortex" OR "gustatory area"),"Ventromedial prefrontal",0,153,3,156,0.0
Hypothalam*,"Superior temporal",37,107512,4070,111582,0.000331594701654
"Dentate gyrus","Wernicke's area",1,11442,250,11692,8.55285665412e-05
(Inferior AND collicul*),"Piriform cortex",33,4250,1710,5960,0.00553691275168
Hippocamp*,Insula*,761,103333,16412,119745,0.0063551714059
"Globus pallidus",Premotor,107,7999,4622,12621,0.00847793360273
Insula*,"Superior temporal",464,16709,3643,20352,0.0227987421384
Insula*,Thalamus,1078,16095,41804,57899,0.0186186289919
Hippocamp*,"Piriform cortex",820,103274,923,104197,0.00786970834093
(Inferior AND collicul*),Suprachiasmatic,30,4253,5996,10249,0.00292711484047
("Mammillary body" OR "Mammillary bodies),"Nucleus basalis",9,9,1843,1852,0.0048596112311
periaqueductal,Pineal,17,4559,14386,18945,0.000897334389021
"Olfactory bulb",Parahippocamp*,20,11191,2639,13830,0.00144613159798
periaqueductal,Pulvinar,14,4562,1119,5681,0.0024643548671
"Pontine nuclei",Precuneus,0,798,1220,2018,0.0
("Locus coeruleus" OR "locus ceruleus"),"Primary motor",17,7622,3188,10810,0.00157261794635
"Nucleus accumbens",Temporoparietal,2,12543,1458,14001,0.000142846939504
Operculum,"Superior temporal",75,851,4032,4883,0.0153594101986
Orbitofrontal,"Stria terminalis",18,2978,2712,5690,0.00316344463972
Orbitofrontal,Parahippocamp*,142,2854,2517,5371,0.02643827965
"Posterior cingulate",("Ventral anterior" AND (nuclei OR nucleus)),3,1899,234,2133,0.0014064697609
Orbitofrontal,"Visual cortex",77,2919,22803,25722,0.00299354638053
"Primary auditory",("Red nucleus"),2,1867,2374,4241,0.000471586889884
("Straight gyrus" OR "gyrus rectus"),(Septal AND (nuclei OR nucleus)),1,129,4659,4788,0.000208855472013
"Middle temporal","Superior frontal",98,1539,993,2532,0.0387045813586
"Piriform cortex","Pontine nuclei",25,1718,773,2491,0.0100361300682
(Periventricular AND (nuclei OR nucleus)),"Postcentral gyrus",1,2494,530,3024,0.000330687830688
"Middle temporal","Ventral tegmentum",0,1637,285,1922,0.0
Striatum,"Superior frontal",58,58882,1033,59915,0.00096803805391
"Stria terminalis",("Superior olive" OR "superior olivary"),15,2715,1242,3957,0.00379075056861
(Raphe AND (nuclei OR nucleus)),("Ventral posterolateral" AND (nuclei OR nucleus)),7,8314,141,8455,0.000827912477824
("Red nucleus"),Striatum,297,2079,58643,60722,0.00489114324298
"Angular gyrus","Diagonal band of Broca",0,502,895,1397,0.0
Cerebellum,("Nucleus cuneatus" OR "cuneate nucleus"),123,65277,569,65846,0.00186799501868
(Cochlear AND (nuclei OR nucleus)),"Stria terminalis",20,5287,2710,7997,0.00250093785169
Cerebellum,"Posterior parahippocampal gyrus",2,65398,39,65437,3.05637483381e-05
(Intralaminar AND (nuclei OR nucleus)),Subgranular,0,1100,632,1732,0.0
(Dorsomedial AND hypothal*),"Inferior temporal",1,2138,1710,3848,0.000259875259875
"Globus pallidus",(Superior AND collicul*),172,7934,9912,17846,0.00963801412081
("Gustatory cortex" OR "gustatory area"),Parahippocamp*,3,150,2656,2806,0.00106913756237
Caudate,(Periventricular AND (nuclei OR nucleus)),166,18635,2329,20964,0.00791833619538
Cingulum,Putamen,27,658,10722,11380,0.00237258347979
Claustrum,Pons,1750,80991,23834,104825,0.016694490818
"Indusium griseum","Middle temporal",0,77,1637,1714,0.0
(Inferior AND collicul*),(Medulla OR "medulla oblongata"),560,3723,50262,53985,0.0103732518292
("Inferior olive" OR "Inferior olivary"),Operculum,1,2379,925,3304,0.000302663438257
"Inferior parietal lobule","Pontine nuclei",3,793,795,1588,0.00188916876574
"Inferior parietal lobule","Posterior parietal",54,742,2100,2842,0.0190007037298
"Inferior parietal lobule","Interstitial nucleus",2,794,512,1306,0.00153139356815
"Globus pallidus","Postcentral gyrus",6,8100,525,8625,0.000695652173913
"Lingual gyrus","Medial geniculate",0,254,1249,1503,0.0
"Interstitial nucleus",Perirhinal,1,513,1199,1712,0.000584112149533
("Nucleus cuneatus" OR "cuneate nucleus"),Prefrontal,2,690,24099,24789,8.06809471943e-05
("Medial dorsal" AND nucl*),("Superior olive" OR "superior olivary"),0,113,1257,1370,0.0
Parahippocamp*,"Piriform cortex",30,2629,1713,4342,0.00690925840626
"Medial geniculate","Posterior parahippocampal gyrus",0,1249,41,1290,0.0
"Middle temporal",Orbitofrontal,49,1588,2947,4535,0.0108048511577
"Nucleus accumbens",Subiculum,1773,10772,96468,107240,0.0165330100709
"Nucleus accumbens","Superior temporal",22,12523,4085,16608,0.0013246628131
(Medulla OR "medulla oblongata"),Suprachiasmatic,110,50712,5916,56628,0.0019425019425
"Postcentral gyrus","Primary sensory",14,517,2996,3513,0.00398519783661
"Nucleus accumbens",Prefrontal,1821,10724,22280,33004,0.0551751302872
"Middle frontal","Ventromedial prefrontal",0,1028,3,1031,0.0
Pons,"Postcentral gyrus",12,25572,519,26091,0.00045992871105
Perirhinal,Subthalam*,10,1190,4119,5309,0.00188359389716
"Posterior parahippocampal gyrus","Superior frontal",0,41,1091,1132,0.0
"Middle temporal",("Red nucleus"),1,1636,2375,4011,0.00024931438544
Pineal,"Ventral tegmentum",2,14401,283,14684,0.000136202669572
"Posterior parahippocampal gyrus","Ventral tegmentum",0,41,285,326,0.0
"Piriform cortex",Temporoparietal,1,1742,1459,3201,0.000312402374258
"Posterior parietal",("Red nucleus"),4,2150,2372,4522,0.000884564352057
(Septal AND (nuclei OR nucleus)),"Ventromedial prefrontal",0,4660,3,4663,0.0
Putamen,Subiculum,1699,9050,96542,105592,0.0160902341086
Subgranular,"Ventral tegmentum",0,632,285,917,0.0
(Raphe AND (nuclei OR nucleus)),("Red nucleus"),139,8182,2237,10419,0.0133410116134
"Amygdala",(Septal AND (nuclei OR nucleus)),830,22527,3830,26357,0.0314906855864
"Angular gyrus",Temporoparietal,13,489,1447,1936,0.00671487603306
"Angular gyrus","Globus pallidus",0,502,8106,8608,0.0
"Angular gyrus",Pons,4,498,25580,26078,0.000153385995859
"Lateral geniculate",("Medial dorsal" AND nucl*),2,5178,111,5289,0.000378143316317
(Intralaminar AND (nuclei OR nucleus)),"Piriform cortex",11,1089,1732,2821,0.00389932647997
("Centromedian" AND (nuclei OR nucleus)),"Ventral tegmentum",0,216,285,501,0.0
"Lateral geniculate",("Straight gyrus" OR "gyrus rectus"),0,5180,130,5310,0.0
"Dentate gyrus",(Dorsomedial AND hypothal*),40,11403,2099,13502,0.00296252407051
"Basal forbrain","Visual extrastriate",0,1,1534,1535,0.0
"Broca's area","Substantia nigra",3,691,19384,20075,0.000149439601494
"Broca's area","Primary motor",30,664,3175,3839,0.00781453503517
Fusiform,"Piriform cortex",6,5449,1737,7186,0.000834956860562
("Heschl's gyrus" OR "Transverse temporal"),"Nucleus accumbens",1,1147,12544,13691,7.30406836608e-05
Caudate,(Inferior AND collicul*),166,18635,4117,22752,0.00729606188467
Fusiform,("Gustatory cortex" OR "gustatory area"),0,5455,153,5608,0.0
"Globus pallidus","Nucleus accumbens",609,7497,11936,19433,0.0313384449133
"Lingual gyrus",Temporoparietal,5,249,1455,1704,0.00293427230047
("Locus coeruleus" OR "locus ceruleus"),"Middle temporal",5,7634,1632,9266,0.000539607165983
("Nucleus gracilis" OR "gracile nucleus"),("Superior olive" OR "superior olivary"),6,368,1251,1619,0.00370599135269
periaqueductal,"Supplementary motor",16,4560,2345,6905,0.00231716147719
periaqueductal,"Posterior cingulate",18,4558,1884,6442,0.00279416330332
Perirhinal,"Piriform cortex",59,1141,1684,2825,0.0208849557522
Perirhinal,"Primary motor",9,1191,3196,4387,0.00205151584226
"Postcentral gyrus",Subiculum,35,496,98206,98702,0.000354602743612
"Nucleus basalis","Posterior cingulate",6,1841,1896,3737,0.001605565962
"Posterior cingulate","Stria terminalis",3,1899,2727,4626,0.00064850843061
Perirhinal,Thalamus,134,1066,42748,43814,0.0030583831652
(Periventricular AND (nuclei OR nucleus)),"Primary motor",3,2492,3202,5694,0.000526870389884
("Red nucleus"),"Superior temporal",5,2371,4102,6473,0.00077243936351
"Middle frontal","Piriform cortex",2,1026,1741,2767,0.000722804481388
("Straight gyrus" OR "gyrus rectus"),"Ventromedial prefrontal",0,130,3,133,0.0
"Primary auditory",Temporoparietal,8,1861,1452,3313,0.0024147298521
("Ventral anterior" AND (nuclei OR nucleus)),("Ventral posterior" AND (nuclei OR nucleus)),23,214,333,547,0.0420475319927
Precuneus,Temporoparietal,46,1174,1414,2588,0.0177743431221
Subgranular,Thalamus,5,627,42877,43504,0.00011493196028
periaqueductal,"Piriform cortex",31,4545,1712,6257,0.00495445101486
("Ventral anterior" AND (nuclei OR nucleus)),"Zona incerta",12,225,962,1187,0.0101095197978
"Ventromedial prefrontal","Visual extrastriate",0,3,1534,1537,0.0
Ambiguus,"Nucleus basalis",2,1214,1845,3059,0.000653808434129
Ambiguus,"Primary motor",1,1215,3204,4419,0.000226295541978
"Anterior cingulate",Infralimbic,112,5690,384,6074,0.0184392492591
"Anterior cingulate","Medial frontal",342,5460,1253,6713,0.0509459258156
"Angular gyrus",("Nucleus gracilis" OR "gracile nucleus"),0,502,374,876,0.0
"Anterior cingulate",Subthalam*,35,5767,4094,9861,0.00354933576716
(Dorsomedial AND hypothal*),"Middle frontal",0,2139,1028,3167,0.0
"Dorsolateral prefrontal","Paracentral lobule",2,3002,63,3065,0.000652528548124
Ambiguus,"Supplementary motor",2,1214,2359,3573,0.000559753708368
(Dorsomedial AND hypothal*),Temporoparietal,0,2139,1460,3599,0.0
"Basal forbrain",Prefrontal,0,1,24101,24102,0.0
Entorhinal,Parahippocamp*,414,5133,2245,7378,0.0561127676877
Caudate,"Inferior temporal",63,18738,1648,20386,0.00309035612675
"Broca's area",Precuneus,10,684,1210,1894,0.00527983104541
("Heschl's gyrus" OR "Transverse temporal"),"Ventral tegmentum",0,1148,285,1433,0.0
Cingulate,Subgranular,2,11102,630,11732,0.000170473917491
(Inferior AND collicul*),("Nucleus cuneatus" OR "cuneate nucleus"),28,4255,664,4919,0.00569221386461
"Indusium griseum","Inferior parietal lobule",0,77,796,873,0.0
"Inferior parietal lobule",Pulvinar,24,772,1109,1881,0.0127591706539
("Locus coeruleus" OR "locus ceruleus"),("Nucleus cuneatus" OR "cuneate nucleus"),24,7615,668,8283,0.00289750090547
"Medial frontal","Nucleus accumbens",60,1535,12485,14020,0.00427960057061
"Nucleus basalis",(Septal AND (nuclei OR nucleus)),181,1666,4479,6145,0.0294548413344
("Nucleus gracilis" OR "gracile nucleus"),Premotor,1,373,4728,5101,0.000196039992158
(Inferior AND collicul*),("Ventral posterior" AND (nuclei OR nucleus)),7,4276,349,4625,0.00151351351351
Parahippocamp*,"Visual cortex",119,2540,22761,25301,0.00470337140824
Infralimbic,("Nucleus cuneatus" OR "cuneate nucleus"),0,496,692,1188,0.0
periaqueductal,"Primary motor",7,4569,3198,7767,0.000901248873439
Pons,"Ventromedial prefrontal",0,25584,3,25587,0.0
"Nucleus accumbens",Subgranular,3,12542,629,13171,0.000227773137955
"Posterior parahippocampal gyrus","Primary auditory",0,41,1869,1910,0.0
Premotor,Suprachiasmatic,2,4727,6024,10751,0.000186029206585
"Middle frontal",("Posterior nucleus" AND hypothalamus),0,1028,67,1095,0.0
"Stria terminalis",Subiculum,447,2283,97794,100077,0.00446656074822
Precuneus,("Ventral posterolateral" AND (nuclei OR nucleus)),0,1220,148,1368,0.0
"Substantia nigra","Visual extrastriate",2,19385,1532,20917,9.56160061194e-05
Ambiguus,"Indusium griseum",0,1216,77,1293,0.0
"Angular gyrus",Claustrum,19,483,82722,83205,0.000228351661559
"Angular gyrus",("Ventral posteromedial" AND (nuclei OR nucleus)),0,502,112,614,0.0
"Angular gyrus",(Intralaminar AND (nuclei OR nucleus)),0,502,1100,1602,0.0
"Calcarine fissure",(Intralaminar AND (nuclei OR nucleus)),1,102,1099,1201,0.000832639467111
("Centromedian" AND (nuclei OR nucleus)),("Red nucleus"),2,214,2374,2588,0.000772797527048
Cerebellum,"Ventral tegmentum",17,65383,268,65651,0.000258945027494
(Cochlear AND (nuclei OR nucleus)),"Supplementary motor",0,5307,2361,7668,0.0
"Lateral geniculate","Stria terminalis",33,5147,2697,7844,0.00420703722591
"Dorsolateral prefrontal","Piriform cortex",4,3000,1739,4739,0.000844059928255
(Dorsomedial AND hypothal*),Prefrontal,72,2067,24029,26096,0.00275904353158
(Dorsomedial AND hypothal*),Putamen,79,2060,10670,12730,0.00620581304006
(Dorsomedial AND hypothal*),(Inferior AND collicul*),40,2099,4243,6342,0.00630715862504
"Globus pallidus",("Ventral posterior" AND (nuclei OR nucleus)),14,8092,342,8434,0.00165994783021
"Broca's area",Suprachiasmatic,0,694,6026,6720,0.0
("Heschl's gyrus" OR "Transverse temporal"),"Lingual gyrus",1,1147,253,1400,0.000714285714286
("Gustatory cortex" OR "gustatory area"),Subiculum,14,139,98227,98366,0.000142325600309
("Heschl's gyrus" OR "Transverse temporal"),("Nucleus cuneatus" OR "cuneate nucleus"),0,1148,692,1840,0.0
Claustrum,"Ventromedial prefrontal",0,82741,3,82744,0.0
Fusiform,(Septal AND (nuclei OR nucleus)),24,5431,4636,10067,0.00238402701897
Entorhinal,("Ventral anterior" AND (nuclei OR nucleus)),2,5545,235,5780,0.000346020761246
("Inferior olive" OR "Inferior olivary"),("Ventral posterolateral" AND (nuclei OR nucleus)),2,2378,146,2524,0.000792393026941
Hippocamp*,"Nucleus basalis",434,103660,1413,105073,0.00413046167902
("Inferior olive" OR "Inferior olivary"),"Lingual gyrus",0,2380,254,2634,0.0
"Nucleus basalis",("Red nucleus"),5,1842,2371,4213,0.00118680275338
("Medial dorsal" AND nucl*),"Stria terminalis",2,111,2728,2839,0.000704473406129
("Medial dorsal" AND nucl*),Pons,8,105,25576,25681,0.00031151434913
("Nucleus gracilis" OR "gracile nucleus"),"Thalamic reticular",1,373,599,972,0.00102880658436
"Inferior frontal",Insula*,412,2400,16761,19161,0.0215020092897
(Medulla OR "medulla oblongata"),"Pontine nuclei",139,50683,659,51342,0.00270733512524
Perirhinal,("Posterior nucleus" AND hypothalamus),4,1196,63,1259,0.00317712470214
"Nucleus accumbens",Pineal,23,12522,14380,26902,0.000854955021931
"Medial frontal","Substantia nigra",9,1586,19378,20964,0.000429307384087
"Primary motor",Pulvinar,8,3197,1125,4322,0.00185099490976
Pineal,Suprachiasmatic,588,13815,5438,19253,0.0305406949566
Thalamus,"Thalamic reticular",529,42353,71,42424,0.0124693569678
("Ventral posterolateral" AND (nuclei OR nucleus)),("Ventral posteromedial" AND (nuclei OR nucleus)),31,117,81,198,0.156565656566
("Ventral posterior" AND (nuclei OR nucleus)),"Wernicke's area",0,356,251,607,0.0
Subgranular,("Ventral posteromedial" AND (nuclei OR nucleus)),0,632,112,744,0.0
"Lingual gyrus","Ventromedial prefrontal",0,254,3,257,0.0
Subthalam*,("Superior olive" OR "superior olivary"),6,4123,1251,5374,0.00111648678824
Infralimbic,"Primary motor",3,493,3202,3695,0.000811907983762
Ambiguus,"Piriform cortex",5,1211,1738,2949,0.00169548999661
"Angular gyrus","Dorsolateral prefrontal",31,471,2973,3444,0.00900116144019
"Anterior cingulate",Insula*,1194,4608,15979,20587,0.0579977655802
"Calcarine fissure","Dentate gyrus",0,103,11443,11546,0.0
"Calcarine fissure","Globus pallidus",0,103,8106,8209,0.0
"Lateral geniculate",Prefrontal,25,5155,24076,29231,0.00085525640587
Cingulate,"Posterior parietal",283,10821,1871,12692,0.0222975102427
"Dorsolateral prefrontal",(Dorsomedial AND hypothal*),4,3000,2135,5135,0.000778967867575
"Diagonal band of Broca","Olfactory bulb",70,825,11141,11966,0.00584990807287
"Diagonal band of Broca","Paracentral lobule",0,895,65,960,0.0
"Broca's area","Piriform cortex",0,694,1743,2437,0.0
("Heschl's gyrus" OR "Transverse temporal"),periaqueductal,1,1147,4575,5722,0.000174764068508
"Calcarine fissure",(Septal AND (nuclei OR nucleus)),0,103,4660,4763,0.0
("Centromedian" AND (nuclei OR nucleus)),(Intralaminar AND (nuclei OR nucleus)),58,158,1042,1200,0.0483333333333
("Heschl's gyrus" OR "Transverse temporal"),Prefrontal,26,1122,24075,25197,0.00103186887328
Cingulum,"Superior frontal",12,673,1079,1752,0.00684931506849
("Heschl's gyrus" OR "Transverse temporal"),Hippocamp*,81,1067,104013,105080,0.000770841263799
Claustrum,"Zona incerta",147,82594,827,83421,0.00176214622217
"Dentate gyrus","Lateral geniculate",29,11414,5151,16565,0.00175067914277
("Gustatory cortex" OR "gustatory area"),("Ventral posterior" AND (nuclei OR nucleus)),0,153,356,509,0.0
(Cochlear AND (nuclei OR nucleus)),"Paracentral lobule",0,5307,65,5372,0.0
Hypothalam*,"Posterior parietal",15,107534,2139,109673,0.000136770216918
"Inferior parietal lobule",Parahippocamp*,69,727,2590,3317,0.0208019294543
"Inferior parietal lobule",Thalamus,83,713,42799,43512,0.00190751976466
("Inferior olive" OR "Inferior olivary"),Perirhinal,3,2377,1197,3574,0.000839395635143
("Inferior olive" OR "Inferior olivary"),Subiculum,148,2232,98093,100325,0.00147520558186
"Interstitial nucleus","Wernicke's area",0,514,251,765,0.0
"Lingual gyrus","Visual extrastriate",13,241,1521,1762,0.00737797956867
("Mammillary body" OR "Mammillary bodies),Prefrontal,32,1337,24069,25406,0.00125954498937
("Nucleus cuneatus" OR "cuneate nucleus"),"Posterior parahippocampal gyrus",0,692,41,733,0.0
"Inferior frontal","Middle frontal",310,2502,718,3220,0.0962732919255
("Medial dorsal" AND nucl*),Operculum,2,111,924,1035,0.00193236714976
"Inferior frontal","Paracentral lobule",5,2807,60,2867,0.00174398325776
("Nucleus gracilis" OR "gracile nucleus"),"Primary auditory",0,374,1869,2243,0.0
Parahippocamp*,periaqueductal,13,2646,4563,7209,0.00180330142877
Parahippocamp*,(Superior AND collicul*),10,2649,10074,12723,0.000785978149807
"Middle temporal","Paracentral lobule",5,1632,60,1692,0.00295508274232
"Nucleus accumbens","Pontine nuclei",21,12524,777,13301,0.0015788286595
"Olfactory bulb",Subthalam*,37,11174,4092,15266,0.00242368662387
"Olfactory bulb",("Ventral posteromedial" AND (nuclei OR nucleus)),2,11209,110,11319,0.000176694054245
"Posterior cingulate","Zona incerta",1,1901,973,2874,0.000347947112039
"Middle temporal","Middle frontal",126,1511,902,2413,0.0522171570659
"Primary auditory",Subiculum,49,1820,98192,100012,0.000489941207055
Perirhinal,"Zona incerta",15,1185,959,2144,0.00699626865672
"Primary sensory","Zona incerta",3,3007,971,3978,0.000754147812971
Pineal,Subthalam*,7,14396,4122,18518,0.000378010584296
"Posterior parietal",Thalamus,194,1960,42688,44648,0.00434509944454
"Posterior parietal",Putamen,40,2114,10709,12823,0.0031193948374
Subthalam*,Suprachiasmatic,15,4114,6011,10125,0.00148148148148
Ambiguus,("Locus coeruleus" OR "locus ceruleus"),80,1136,7559,8695,0.00920069005175
"Anterior cingulate",("Straight gyrus" OR "gyrus rectus"),19,5783,111,5894,0.00322361723787
"Angular gyrus",("Nucleus cuneatus" OR "cuneate nucleus"),0,502,692,1194,0.0
"Lateral geniculate","Olfactory bulb",36,5144,11175,16319,0.00220601752558
"Basal forbrain",("Mammillary body" OR "Mammillary bodies),0,1,85,86,0.0
Cerebellum,Operculum,52,65348,874,66222,0.000785237534354
("Centromedian" AND (nuclei OR nucleus)),"Visual cortex",1,215,22879,23094,4.33012903785e-05
Cerebellum,("Mammillary body" OR "Mammillary bodies),105,65295,1264,66559,0.0015775477396
Entorhinal,"Pontine nuclei",18,5529,780,6309,0.00285306704708
"Broca's area",Infralimbic,0,694,496,1190,0.0
("Heschl's gyrus" OR "Transverse temporal"),Striatum,9,1139,58931,60070,0.000149825203929
Caudate,"Posterior cingulate",119,18682,1783,20465,0.00581480576594
(Cochlear AND (nuclei OR nucleus)),"Piriform cortex",13,5294,1730,7024,0.00185079726651
(Inferior AND collicul*),periaqueductal,193,4090,4383,8473,0.022778236752
"Inferior frontal","Stria terminalis",0,2812,2730,5542,0.0
Fusiform,"Visual cortex",352,5103,22528,27631,0.012739314538
"Globus pallidus",("Nucleus gracilis" OR "gracile nucleus"),7,8099,367,8466,0.0008268367588
"Interstitial nucleus",periaqueductal,58,456,4518,4974,0.0116606353036
"Lingual gyrus",Operculum,6,248,920,1168,0.00513698630137
"Inferior temporal",Suprachiasmatic,0,1711,6026,7737,0.0
("Locus coeruleus" OR "locus ceruleus"),"Medial frontal",12,7627,1583,9210,0.00130293159609
"Inferior frontal","Piriform cortex",4,2808,1739,4547,0.000879700901693
Infralimbic,(Medulla OR "medulla oblongata"),35,461,50787,51248,0.000682953481111
("Nucleus gracilis" OR "gracile nucleus"),"Supplementary motor",0,374,2361,2735,0.0
"Middle temporal",("Nucleus cuneatus" OR "cuneate nucleus"),0,1637,692,2329,0.0
Orbitofrontal,"Paracentral lobule",3,2993,62,3055,0.000981996726678
"Paracentral lobule",Striatum,4,61,58936,58997,6.780005763e-05
"Middle temporal",("Superior olive" OR "superior olivary"),0,1637,1257,2894,0.0
"Middle frontal","Posterior parietal",29,999,2125,3124,0.00928297055058
"Ventral tegmentum","Visual extrastriate",0,285,1534,1819,0.0
Thalamus,("Ventral posterolateral" AND (nuclei OR nucleus)),132,42750,16,42766,0.00308656409297
"Amygdala",Subthalam*,129,23228,4000,27228,0.00473776994271
Cingulate,Infralimbic,159,10945,337,11282,0.0140932458784
"Dorsolateral prefrontal","Posterior parietal",146,2858,2008,4866,0.0300041101521
(Dorsomedial AND hypothal*),"Ventromedial prefrontal",0,2139,3,2142,0.0
Ambiguus,"Thalamic reticular",0,1216,600,1816,0.0
Fusiform,Pulvinar,26,5429,1107,6536,0.00397796817625
"Dorsolateral prefrontal",Insula*,258,2746,16915,19661,0.0131224251055
Cingulate,"Zona incerta",36,11068,938,12006,0.00299850074963
Cingulum,"Lingual gyrus",4,681,250,931,0.00429645542427
Cingulum,("Straight gyrus" OR "gyrus rectus"),2,683,128,811,0.00246609124538
Claustrum,("Ventral anterior" AND (nuclei OR nucleus)),115,82626,122,82748,0.00138976168608
"Dentate gyrus","Primary sensory",9,11434,3001,14435,0.000623484586076
Hippocamp*,("Medial dorsal" AND nucl*),23,104071,90,104161,0.000220812012173
"Interstitial nucleus",Operculum,0,514,926,1440,0.0
Entorhinal,"Ventromedial prefrontal",0,5547,3,5550,0.0
Hippocamp*,Infralimbic,116,103978,380,104358,0.00111155828973
Hippocamp*,"Paracentral lobule",4,104090,61,104151,3.84057762287e-05
("Locus coeruleus" OR "locus ceruleus"),"Paracentral lobule",0,7639,65,7704,0.0
"Nucleus basalis",Subgranular,0,1847,632,2479,0.0
(Inferior AND collicul*),(Septal AND (nuclei OR nucleus)),53,4230,4607,8837,0.00599751046735
("Nucleus gracilis" OR "gracile nucleus"),(Periventricular AND (nuclei OR nucleus)),4,370,2491,2861,0.00139811254806
Infralimbic,"Medial geniculate",3,493,1246,1739,0.0017251293847
"Medial geniculate","Postcentral gyrus",0,1249,531,1780,0.0
"Middle frontal",("Superior olive" OR "superior olivary"),0,1028,1257,2285,0.0
("Locus coeruleus" OR "locus ceruleus"),Perirhinal,22,7617,1178,8795,0.00250142126208
"Pontine nuclei",Striatum,76,722,58864,59586,0.00127546739167
("Locus coeruleus" OR "locus ceruleus"),(Periventricular AND (nuclei OR nucleus)),213,7426,2282,9708,0.0219406674907
"Pontine nuclei",Temporoparietal,0,798,1460,2258,0.0
"Nucleus accumbens","Posterior parahippocampal gyrus",0,12545,41,12586,0.0
"Postcentral gyrus","Primary auditory",0,531,1869,2400,0.0
"Paracentral lobule",Pons,1,64,25583,25647,3.89909151168e-05
(Medulla OR "medulla oblongata"),"Wernicke's area",1,50821,250,51071,1.9580583893e-05
Pineal,Prefrontal,7,14396,24094,38490,0.00018186541959
"Middle temporal",(Superior AND collicul*),24,1613,10060,11673,0.00205602672835
"Stria terminalis","Visual cortex",5,2725,22875,25600,0.0001953125
(Superior AND collicul*),"Superior temporal",44,10040,4063,14103,0.00311990356662
(Superior AND collicul*),"Ventromedial prefrontal",0,10084,3,10087,0.0
"Posterior parietal",Prefrontal,521,1633,23580,25213,0.0206639432039
Subiculum,"Wernicke's area",6,98235,245,98480,6.09260763607e-05
"Anterior cingulate","Lingual gyrus",49,5753,205,5958,0.00822423632091
Cerebellum,"Nucleus basalis",74,65326,1773,67099,0.00110284803052
Cingulate,(Dorsomedial AND hypothal*),73,11031,2066,13097,0.00557379552569
(Intralaminar AND (nuclei OR nucleus)),"Primary motor",17,1083,3188,4271,0.00398033247483
"Lateral geniculate",Pulvinar,224,4956,909,5865,0.0381926683717
(Intralaminar AND (nuclei OR nucleus)),("Superior olive" OR "superior olivary"),2,1098,1255,2353,0.000849978750531
(Cochlear AND (nuclei OR nucleus)),"Zona incerta",14,5293,960,6253,0.00223892531585
(Dorsomedial AND hypothal*),("Inferior olive" OR "Inferior olivary"),22,2117,2358,4475,0.00491620111732
"Basal forbrain",Subiculum,0,1,98241,98242,0.0
Fusiform,"Middle temporal",186,5269,1451,6720,0.0276785714286
"Basal forbrain","Piriform cortex",0,1,1743,1744,0.0
"Calcarine fissure",Pons,1,102,25583,25685,3.89332295114e-05
Ambiguus,"Zona incerta",9,1207,965,2172,0.00414364640884
("Centromedian" AND (nuclei OR nucleus)),("Medial dorsal" AND nucl*),4,212,109,321,0.01246105919
Cingulum,Orbitofrontal,18,667,2978,3645,0.00493827160494
"Indusium griseum","Nucleus basalis",0,77,1847,1924,0.0
Entorhinal,Subgranular,10,5537,622,6159,0.00162364020133
"Inferior frontal","Zona incerta",1,2811,973,3784,0.000264270613108
"Inferior parietal lobule","Lingual gyrus",21,775,233,1008,0.0208333333333
"Inferior temporal",("Posterior nucleus" AND hypothalamus),0,1711,67,1778,0.0
"Inferior temporal",("Locus coeruleus" OR "locus ceruleus"),8,1703,7631,9334,0.000857081637026
"Inferior temporal",("Superior olive" OR "superior olivary"),0,1711,1257,2968,0.0
("Medial dorsal" AND nucl*),"Nucleus accumbens",7,106,12538,12644,0.000553622271433
("Nucleus cuneatus" OR "cuneate nucleus"),Orbitofrontal,0,692,2996,3688,0.0
"Lingual gyrus",Subiculum,34,220,98207,98427,0.000345433671655
Hippocamp*,"Posterior cingulate",420,103674,1482,105156,0.00399406595915
("Nucleus cuneatus" OR "cuneate nucleus"),Subiculum,18,674,98223,98897,0.000182007543202
("Nucleus gracilis" OR "gracile nucleus"),"Superior temporal",1,373,4106,4479,0.000223264121456
Infralimbic,"Pontine nuclei",3,493,795,1288,0.00232919254658
"Pontine nuclei",("Posterior nucleus" AND hypothalamus),0,798,67,865,0.0
"Pontine nuclei","Posterior cingulate",3,795,1899,2694,0.0011135857461
"Nucleus accumbens",Suprachiasmatic,91,12454,5935,18389,0.00494861058241
Operculum,"Postcentral gyrus",25,901,506,1407,0.0177683013504
Operculum,"Posterior parietal",29,897,2125,3022,0.00959629384514
"Primary sensory",Subgranular,0,3010,632,3642,0.0
"Primary auditory",Subgranular,0,1869,632,2501,0.0
"Middle frontal",Parahippocamp*,86,942,2573,3515,0.024466571835
(Septal AND (nuclei OR nucleus)),"Visual extrastriate",0,4660,1534,6194,0.0
("Red nucleus"),"Ventromedial prefrontal",0,2376,3,2379,0.0
Striatum,("Superior olive" OR "superior olivary"),18,58922,1239,60161,0.000299197154303
"Posterior parietal",Precuneus,62,2092,1158,3250,0.0190769230769
"Piriform cortex",("Ventral posterior" AND (nuclei OR nucleus)),3,1740,353,2093,0.00143334925944
(Superior AND collicul*),"Supplementary motor",14,10070,2347,12417,0.00112748651043
"Superior temporal","Wernicke's area",57,4050,194,4244,0.0134307257304
"Primary motor","Visual extrastriate",7,3198,1527,4725,0.00148148148148
"Piriform cortex","Thalamic reticular",5,1738,595,2333,0.00214316330904
Subgranular,"Supplementary motor",0,632,2361,2993,0.0
Cerebellum,"Olfactory bulb",1434,63966,9777,73743,0.0194459135104
Cerebellum,"Supplementary motor",441,64959,1920,66879,0.006593998116
Cerebellum,("Centromedian" AND (nuclei OR nucleus)),12,65388,204,65592,0.000182949140139
(Cochlear AND (nuclei OR nucleus)),Thalamus,237,5070,42645,47715,0.0049669915121
Cerebellum,"Zona incerta",95,65305,879,66184,0.00143539223982
(Intralaminar AND (nuclei OR nucleus)),"Superior frontal",0,1100,1091,2191,0.0
Cingulate,Cingulum,115,10989,570,11559,0.00994895752228
Entorhinal,("Medial dorsal" AND nucl*),7,5540,106,5646,0.0012398157988
"Broca's area",Striatum,12,682,58928,59610,0.000201308505284
Caudate,"Primary sensory",16,18785,2994,21779,0.000734652647045
("Gustatory cortex" OR "gustatory area"),("Inferior olive" OR "Inferior olivary"),0,153,2380,2533,0.0
Caudate,Cingulum,38,18763,647,19410,0.00195775373519
"Calcarine fissure","Wernicke's area",0,103,251,354,0.0
("Heschl's gyrus" OR "Transverse temporal"),"Posterior parietal",3,1145,2151,3296,0.000910194174757
(Cochlear AND (nuclei OR nucleus)),Pons,1756,3551,23828,27379,0.064136747142
("Inferior olive" OR "Inferior olivary"),"Primary sensory",7,2373,3003,5376,0.00130208333333
Insula*,("Straight gyrus" OR "gyrus rectus"),8,17165,122,17287,0.000462775496037
"Interstitial nucleus","Visual cortex",2,512,22878,23390,8.55066267636e-05
"Lingual gyrus",Precuneus,48,206,1172,1378,0.0348330914369
(Inferior AND collicul*),(Raphe AND (nuclei OR nucleus)),157,4126,8164,12290,0.0127746135069
(Inferior AND collicul*),Thalamus,831,3452,42051,45503,0.0182625321407
"Inferior frontal","Posterior parietal",65,2747,2089,4836,0.0134408602151
periaqueductal,("Posterior nucleus" AND hypothalamus),7,4569,60,4629,0.00151220565997
(Medulla OR "medulla oblongata"),Operculum,6,50816,920,51736,0.000115973403433
Perirhinal,"Pontine nuclei",5,1195,793,1988,0.00251509054326
Infralimbic,("Ventral posteromedial" AND (nuclei OR nucleus)),0,496,112,608,0.0
"Medial frontal","Superior temporal",119,1476,3988,5464,0.0217789165447
Pons,"Posterior parietal",21,25563,2133,27696,0.000758232235702
Premotor,"Primary auditory",17,4712,1852,6564,0.00258988421694
"Primary auditory","Visual extrastriate",4,1865,1530,3395,0.00117820324006
(Periventricular AND (nuclei OR nucleus)),Striatum,186,2309,58754,61063,0.00304603442346
("Red nucleus"),"Wernicke's area",0,2376,251,2627,0.0
"Stria terminalis","Superior temporal",2,2728,4105,6833,0.000292697204742
(Raphe AND (nuclei OR nucleus)),Subgranular,3,8318,629,8947,0.000335307924444
Subgranular,"Visual cortex",1,631,22879,23510,4.25350914504e-05
Putamen,"Visual extrastriate",9,10740,1525,12265,0.000733795352629
Infralimbic,"Medial geniculate",3,493,1246,1739,0.0017251293847
(Raphe AND (nuclei OR nucleus)),("Ventral anterior" AND (nuclei OR nucleus)),9,8312,228,8540,0.00105386416862
Ambiguus,(Intralaminar AND (nuclei OR nucleus)),5,1211,1095,2306,0.0021682567216
"Angular gyrus","Indusium griseum",0,502,77,579,0.0
Cerebellum,(Periventricular AND (nuclei OR nucleus)),156,65244,2339,67583,0.00230827279049
(Intralaminar AND (nuclei OR nucleus)),(Septal AND (nuclei OR nucleus)),32,1068,4628,5696,0.00561797752809
"Lingual gyrus",("Locus coeruleus" OR "locus ceruleus"),0,254,7639,7893,0.0
"Diagonal band of Broca","Superior frontal",0,895,1091,1986,0.0
Entorhinal,"Middle temporal",23,5524,1614,7138,0.00322219108994
"Calcarine fissure",("Ventral anterior" AND (nuclei OR nucleus)),0,103,237,340,0.0
("Heschl's gyrus" OR "Transverse temporal"),"Visual extrastriate",0,1148,1534,2682,0.0
Cingulum,"Nucleus basalis",6,679,1841,2520,0.00238095238095
Cingulum,(Raphe AND (nuclei OR nucleus)),20,665,8301,8966,0.00223064911889
(Cochlear AND (nuclei OR nucleus)),("Heschl's gyrus" OR "Transverse temporal"),7,5300,1141,6441,0.00108678776587
"Dentate gyrus",Insula*,50,11393,17123,28516,0.0017534015991
"Dentate gyrus",Pineal,32,11411,14371,25782,0.00124117601427
Hypothalam*,Subiculum,8335,99214,89906,189120,0.0440725465313
Fusiform,Hippocamp*,313,5142,103781,108923,0.00287358959999
("Inferior olive" OR "Inferior olivary"),"Visual extrastriate",1,2379,1533,3912,0.000255623721881
"Inferior frontal","Visual cortex",78,2734,22802,25536,0.0030545112782
("Inferior olive" OR "Inferior olivary"),"Posterior parahippocampal gyrus",0,2380,41,2421,0.0
"Lingual gyrus","Middle frontal",32,222,996,1218,0.0262725779967
("Locus coeruleus" OR "locus ceruleus"),"Ventral tegmentum",30,7609,255,7864,0.00381485249237
(Intralaminar AND (nuclei OR nucleus)),("Medial dorsal" AND nucl*),12,1088,101,1189,0.0100925147183
"Nucleus basalis","Stria terminalis",22,1825,2708,4533,0.00485329803662
("Nucleus cuneatus" OR "cuneate nucleus"),Putamen,8,684,10741,11425,0.000700218818381
"Inferior frontal",("Medial dorsal" AND nucl*),1,2811,112,2923,0.000342114266165
"Nucleus basalis",(Superior AND collicul*),13,1834,10071,11905,0.00109197816044
"Medial geniculate","Primary auditory",149,1100,1720,2820,0.0528368794326
Insula*,"Medial frontal",174,16999,1421,18420,0.00944625407166
"Middle temporal",Perirhinal,7,1630,1193,2823,0.00247963159759
("Locus coeruleus" OR "locus ceruleus"),Pulvinar,27,7612,1106,8718,0.00309704060564
"Pontine nuclei",Subthalam*,27,771,4102,4873,0.00554073466037
"Postcentral gyrus","Substantia nigra",4,527,19383,19910,0.000200904068307
Operculum,Subiculum,31,895,98210,99105,0.000312799556026
"Paracentral lobule","Pontine nuclei",0,65,798,863,0.0
"Medial frontal","Visual extrastriate",9,1586,1525,3111,0.00289296046287
Operculum,"Superior frontal",10,916,1081,1997,0.0050075112669
"Nucleus accumbens","Superior frontal",3,12542,1088,13630,0.0002201027146
"Posterior parahippocampal gyrus",(Superior AND collicul*),0,41,10084,10125,0.0
Pineal,Pons,82,14321,25502,39823,0.00205911156869
Pineal,"Postcentral gyrus",0,14403,531,14934,0.0
(Periventricular AND (nuclei OR nucleus)),"Visual extrastriate",0,2495,1534,4029,0.0
"Middle temporal",(Raphe AND (nuclei OR nucleus)),4,1633,8317,9950,0.000402010050251
("Straight gyrus" OR "gyrus rectus"),Thalamus,10,120,42872,42992,0.000232601414217
"Stria terminalis",Temporoparietal,0,2730,1460,4190,0.0
"Posterior parietal","Primary auditory",11,2143,1858,4001,0.00274931267183
Temporoparietal,"Visual extrastriate",8,1452,1526,2978,0.00268636668905
("Ventral anterior" AND (nuclei OR nucleus)),"Visual extrastriate",1,236,1533,1769,0.000565291124929
Ambiguus,("Gustatory cortex" OR "gustatory area"),1,1215,152,1367,0.000731528895391
"Anterior cingulate","Pontine nuclei",7,5795,791,6586,0.00106286061342
"Anterior cingulate",("Gustatory cortex" OR "gustatory area"),3,5799,150,5949,0.000504286434695
"Amygdala",("Superior olive" OR "superior olivary"),29,23328,1228,24556,0.00118097410002
"Anterior cingulate",Suprachiasmatic,5,5797,6021,11818,0.000423083432053
(Intralaminar AND (nuclei OR nucleus)),"Ventral tegmentum",2,1098,283,1381,0.00144822592324
(Intralaminar AND (nuclei OR nucleus)),"Pontine nuclei",17,1083,781,1864,0.00912017167382
Cerebellum,("Ventral anterior" AND (nuclei OR nucleus)),33,65367,204,65571,0.000503271263211
"Lateral geniculate","Middle frontal",0,5180,1028,6208,0.0
"Basal forbrain",Insula*,0,1,17173,17174,0.0
"Diagonal band of Broca","Stria terminalis",108,787,2622,3409,0.0316808448225
Fusiform,("Mammillary body" OR "Mammillary bodies),7,5448,1362,6810,0.00102790014684
Fusiform,"Olfactory bulb",22,5433,11189,16622,0.00132354710624
(Dorsomedial AND hypothal*),("Straight gyrus" OR "gyrus rectus"),1,2138,129,2267,0.000441111601235
"Amygdala",(Dorsomedial AND hypothal*),331,23026,1808,24834,0.0133285012483
"Calcarine fissure",(Superior AND collicul*),2,101,10082,10183,0.00019640577433
("Centromedian" AND (nuclei OR nucleus)),"Lateral geniculate",5,211,5175,5386,0.000928332714445
"Dentate gyrus",Precuneus,0,11443,1220,12663,0.0
(Cochlear AND (nuclei OR nucleus)),("Nucleus gracilis" OR "gracile nucleus"),7,5300,367,5667,0.00123522145756
Hypothalam*,Insula*,446,107103,16727,123830,0.00360171202455
(Cochlear AND (nuclei OR nucleus)),"Primary auditory",88,5219,1781,7000,0.0125714285714
"Dentate gyrus","Pontine nuclei",45,11398,753,12151,0.00370339889721
(Inferior AND collicul*),Parahippocamp*,7,4276,2652,6928,0.0010103926097
Fusiform,Subthalam*,17,5438,4112,9550,0.00178010471204
"Inferior temporal",(Septal AND (nuclei OR nucleus)),0,1711,4660,6371,0.0
"Inferior parietal lobule",Subthalam*,1,795,4128,4923,0.000203128173878
"Lingual gyrus",(Superior AND collicul*),0,254,10084,10338,0.0
Hippocamp*,("Ventral posterolateral" AND (nuclei OR nucleus)),13,104081,135,104216,0.000124740922699
Insula*,"Wernicke's area",16,17157,235,17392,0.000919963201472
"Inferior frontal",("Mammillary body" OR "Mammillary bodies),2,2810,15,2825,0.00070796460177
("Mammillary body" OR "Mammillary bodies),"Thalamic reticular",35,35,599,634,0.0552050473186
(Inferior AND collicul*),"Visual cortex",108,4175,22772,26947,0.00400786729506
("Nucleus gracilis" OR "gracile nucleus"),("Ventral anterior" AND (nuclei OR nucleus)),0,374,237,611,0.0
"Olfactory bulb",Orbitofrontal,36,11175,2960,14135,0.00254686947294
Infralimbic,(Superior AND collicul*),5,491,10079,10570,0.000473036896878
periaqueductal,"Wernicke's area",0,4576,251,4827,0.0
"Middle temporal","Nucleus basalis",0,1637,1847,3484,0.0
"Nucleus accumbens","Visual cortex",51,12494,22829,35323,0.00144381847521
Operculum,"Posterior cingulate",20,906,1882,2788,0.00717360114778
"Medial frontal","Posterior parietal",44,1551,2110,3661,0.0120185741601
"Medial frontal","Stria terminalis",3,1592,2727,4319,0.000694605232693
"Nucleus accumbens",Striatum,4805,7740,54135,61875,0.0776565656566
(Periventricular AND (nuclei OR nucleus)),"Primary auditory",0,2495,1869,4364,0.0
(Periventricular AND (nuclei OR nucleus)),("Straight gyrus" OR "gyrus rectus"),1,2494,129,2623,0.000381242851697
(Periventricular AND (nuclei OR nucleus)),"Ventromedial prefrontal",0,2495,3,2498,0.0
Pineal,("Posterior nucleus" AND hypothalamus),0,14403,67,14470,0.0
(Septal AND (nuclei OR nucleus)),("Ventral posterolateral" AND (nuclei OR nucleus)),2,4658,146,4804,0.000416319733555
"Thalamic reticular",("Ventral posteromedial" AND (nuclei OR nucleus)),5,595,107,702,0.00712250712251
(Raphe AND (nuclei OR nucleus)),"Thalamic reticular",8,8313,592,8905,0.000898371701291
"Amygdala","Posterior parahippocampal gyrus",10,23347,31,23378,0.000427752587903
"Calcarine fissure","Dorsolateral prefrontal",0,103,3004,3107,0.0
Cerebellum,Perirhinal,28,65372,1172,66544,0.000420774224573
"Basal forbrain",(Cochlear AND (nuclei OR nucleus)),0,1,5307,5308,0.0
"Dorsolateral prefrontal",("Ventral anterior" AND (nuclei OR nucleus)),3,3001,234,3235,0.000927357032457
(Dorsomedial AND hypothal*),"Interstitial nucleus",11,2128,503,2631,0.00418091980236
Ambiguus,Thalamus,27,1189,42855,44044,0.000613023340296
Entorhinal,"Primary sensory",18,5529,2992,8521,0.00211242811877
"Broca's area","Calcarine fissure",0,694,103,797,0.0
("Centromedian" AND (nuclei OR nucleus)),"Inferior temporal",0,216,1711,1927,0.0
Claustrum,"Superior frontal",111,82630,980,83610,0.00132759239325
Hypothalam*,"Paracentral lobule",2,107547,63,107610,1.85856333055e-05
Entorhinal,(Superior AND collicul*),56,5491,10028,15519,0.00360847992783
(Inferior AND collicul*),"Medial frontal",0,4283,1595,5878,0.0
Fusiform,"Superior frontal",67,5388,1024,6412,0.0104491578291
Fusiform,("Ventral posterior" AND (nuclei OR nucleus)),0,5455,356,5811,0.0
(Cochlear AND (nuclei OR nucleus)),("Nucleus cuneatus" OR "cuneate nucleus"),23,5284,669,5953,0.00386359818579
"Inferior temporal","Nucleus accumbens",8,1703,12537,14240,0.000561797752809
("Nucleus cuneatus" OR "cuneate nucleus"),"Wernicke's area",0,692,251,943,0.0
("Nucleus gracilis" OR "gracile nucleus"),Parahippocamp*,0,374,2659,3033,0.0
"Nucleus basalis","Supplementary motor",2,1845,2359,4204,0.000475737392959
("Nucleus gracilis" OR "gracile nucleus"),"Posterior parietal",0,374,2154,2528,0.0
"Inferior frontal","Primary motor",37,2775,3168,5943,0.00622581187952
"Inferior frontal",("Red nucleus"),1,2811,2375,5186,0.000192826841496
Infralimbic,Orbitofrontal,28,468,2968,3436,0.0081490104773
"Middle frontal","Supplementary motor",55,973,2306,3279,0.0167734065264
"Pontine nuclei",(Septal AND (nuclei OR nucleus)),16,782,4644,5426,0.00294876520457
Operculum,Pineal,0,926,14403,15329,0.0
"Olfactory bulb",("Straight gyrus" OR "gyrus rectus"),7,11204,123,11327,0.000617992407522
"Posterior parahippocampal gyrus",Putamen,0,41,10749,10790,0.0
"Primary auditory","Visual cortex",97,1772,22783,24555,0.003950315618
Subthalam*,Thalamus,1218,2911,41664,44575,0.0273247335951
("Nucleus gracilis" OR "gracile nucleus"),"Posterior cingulate",0,374,1902,2276,0.0
Putamen,"Substantia nigra",2021,8728,17366,26094,0.0774507549628
"Amygdala","Inferior frontal",147,23210,2665,25875,0.00568115942029
Ambiguus,"Angular gyrus",0,1216,502,1718,0.0
"Angular gyrus",periaqueductal,1,501,4575,5076,0.000197005516154
(Intralaminar AND (nuclei OR nucleus)),"Posterior parahippocampal gyrus",1,1099,40,1139,0.000877963125549
("Centromedian" AND (nuclei OR nucleus)),"Pontine nuclei",3,213,795,1008,0.00297619047619
"Angular gyrus",(Septal AND (nuclei OR nucleus)),0,502,4660,5162,0.0
"Calcarine fissure","Medial frontal",1,102,1594,1696,0.000589622641509
"Diagonal band of Broca","Ventral tegmentum",1,894,284,1178,0.000848896434635
Entorhinal,"Nucleus basalis",46,5501,1801,7302,0.00629964393317
Entorhinal,("Red nucleus"),17,5530,2359,7889,0.00215489922677
"Calcarine fissure",("Posterior nucleus" AND hypothalamus),0,103,67,170,0.0
"Calcarine fissure","Superior frontal",0,103,1091,1194,0.0
Cingulum,"Dorsolateral prefrontal",15,670,2989,3659,0.00409948073244
"Indusium griseum","Wernicke's area",0,77,251,328,0.0
Fusiform,("Inferior olive" OR "Inferior olivary"),13,5442,2367,7809,0.00166474580612
"Globus pallidus",Pons,267,7839,25317,33156,0.00805284111473
"Inferior parietal lobule",("Locus coeruleus" OR "locus ceruleus"),5,791,7634,8425,0.000593471810089
Hippocamp*,"Medial frontal",165,103929,1430,105359,0.00156607408954
"Interstitial nucleus","Paracentral lobule",0,514,65,579,0.0
("Locus coeruleus" OR "locus ceruleus"),"Ventromedial prefrontal",0,7639,3,7642,0.0
("Mammillary body" OR "Mammillary bodies),"Paracentral lobule",1,1,64,65,0.0153846153846
"Lingual gyrus","Ventromedial prefrontal",0,254,3,257,0.0
Parahippocamp*,Pulvinar,24,2635,1109,3744,0.00641025641026
Parahippocamp*,"Stria terminalis",5,2654,2725,5379,0.000929540806841
Infralimbic,Pineal,0,496,14403,14899,0.0
(Medulla OR "medulla oblongata"),(Raphe AND (nuclei OR nucleus)),1301,49521,7020,56541,0.0230098512584
(Medulla OR "medulla oblongata"),"Superior temporal",5,50817,4102,54919,9.10431726725e-05
Insula*,"Pontine nuclei",19,17154,779,17933,0.0010594992472
"Nucleus accumbens",("Nucleus cuneatus" OR "cuneate nucleus"),11,12534,681,13215,0.000832387438517
"Nucleus basalis",Parahippocamp*,14,1833,2645,4478,0.00312639571237
"Nucleus accumbens","Posterior cingulate",33,12512,1869,14381,0.00229469438843
Operculum,"Substantia nigra",5,921,19382,20303,0.000246269024282
("Posterior nucleus" AND hypothalamus),Putamen,2,65,10747,10812,0.000184979652238
"Posterior cingulate","Wernicke's area",5,1897,246,2143,0.00233317778815
"Primary auditory",(Raphe AND (nuclei OR nucleus)),14,1855,8307,10162,0.00137768155875
"Primary motor",Putamen,117,3088,10632,13720,0.008527696793
("Straight gyrus" OR "gyrus rectus"),Suprachiasmatic,0,130,6026,6156,0.0
Precuneus,Subgranular,0,1220,632,1852,0.0
("Ventral posterolateral" AND (nuclei OR nucleus)),"Visual cortex",1,147,22879,23026,4.34291670286e-05
"Visual cortex","Wernicke's area",16,22864,235,23099,0.000692670678384
"Supplementary motor",Thalamus,329,2032,42553,44585,0.00737916339576
Prefrontal,"Thalamic reticular",15,24086,585,24671,0.000608001297069
"Visual cortex","Zona incerta",21,22859,953,23812,0.000881908281539
Ambiguus,("Centromedian" AND (nuclei OR nucleus)),1,1215,215,1430,0.000699300699301
"Amygdala","Nucleus basalis",187,23170,1660,24830,0.00753121224325
(Intralaminar AND (nuclei OR nucleus)),"Primary auditory",5,1095,1864,2959,0.00168976005407
"Lateral geniculate",("Mammillary body" OR "Mammillary bodies),17,5163,23,5186,0.00327805630544
("Gustatory cortex" OR "gustatory area"),"Interstitial nucleus",1,152,513,665,0.0015037593985
"Diagonal band of Broca",("Nucleus gracilis" OR "gracile nucleus"),4,891,370,1261,0.00317208564631
"Calcarine fissure","Paracentral lobule",0,103,65,168,0.0
("Centromedian" AND (nuclei OR nucleus)),"Dentate gyrus",3,213,11440,11653,0.000257444434909
("Centromedian" AND (nuclei OR nucleus)),Hypothalam*,27,189,107522,107711,0.00025067077643
Caudate,("Gustatory cortex" OR "gustatory area"),2,18799,151,18950,0.000105540897098
Caudate,Fusiform,66,18735,5389,24124,0.00273586469905
(Cochlear AND (nuclei OR nucleus)),("Gustatory cortex" OR "gustatory area"),0,5307,153,5460,0.0
"Indusium griseum",Suprachiasmatic,5,72,6021,6093,0.000820613819137
"Globus pallidus",("Medial dorsal" AND nucl*),3,8103,110,8213,0.000365274564714
"Globus pallidus","Primary sensory",10,8096,3000,11096,0.000901225666907
"Interstitial nucleus",Pons,130,384,25454,25838,0.00503134917563
(Intralaminar AND (nuclei OR nucleus)),"Lingual gyrus",0,1100,254,1354,0.0
Hippocamp*,(Periventricular AND (nuclei OR nucleus)),244,103850,2251,106101,0.00229969557309
("Medial dorsal" AND nucl*),"Wernicke's area",0,113,251,364,0.0
"Nucleus basalis","Superior frontal",5,1842,1086,2928,0.00170765027322
("Nucleus cuneatus" OR "cuneate nucleus"),"Piriform cortex",4,688,1739,2427,0.00164812525752
("Nucleus cuneatus" OR "cuneate nucleus"),"Postcentral gyrus",2,690,529,1219,0.00164068908942
("Nucleus gracilis" OR "gracile nucleus"),periaqueductal,15,359,4561,4920,0.0030487804878
Parahippocamp*,("Ventral anterior" AND (nuclei OR nucleus)),2,2657,235,2892,0.000691562932227
"Medial frontal",Orbitofrontal,95,1500,2901,4401,0.0215860031811
"Olfactory bulb",(Periventricular AND (nuclei OR nucleus)),119,11092,2376,13468,0.00883575883576
("Locus coeruleus" OR "locus ceruleus"),Putamen,198,7441,10551,17992,0.0110048910627
"Nucleus accumbens",Subthalam*,117,12428,4012,16440,0.00711678832117
"Nucleus basalis",Perirhinal,11,1836,1189,3025,0.00363636363636
("Locus coeruleus" OR "locus ceruleus"),Suprachiasmatic,126,7513,5900,13413,0.00939387161709
"Medial frontal",Premotor,70,1525,4659,6184,0.011319534282
"Paracentral lobule",Precuneus,15,50,1205,1255,0.0119521912351
"Posterior cingulate",(Raphe AND (nuclei OR nucleus)),17,1885,8304,10189,0.00166846599274
(Septal AND (nuclei OR nucleus)),"Superior temporal",3,4657,4104,8761,0.000342426663623
Thalamus,("Ventral anterior" AND (nuclei OR nucleus)),197,42685,40,42725,0.00461088355764
Precuneus,"Stria terminalis",0,1220,2730,3950,0.0
Pulvinar,Subiculum,47,1086,98194,99280,0.000473408541499
Subgranular,"Substantia nigra",8,624,19379,20003,0.000399940008999
Subiculum,("Ventral posterior" AND (nuclei OR nucleus)),14,98227,342,98569,0.000142032484858
Prefrontal,Subgranular,5,24096,627,24723,0.000202240828378
Infralimbic,"Medial frontal",27,469,1568,2037,0.0132547864507
Cerebellum,Parahippocamp*,216,65184,2443,67627,0.0031939905659
Cingulate,("Inferior olive" OR "Inferior olivary"),19,11085,2361,13446,0.00141305964599
Cerebellum,Temporoparietal,61,65339,1399,66738,0.000914021996464
(Intralaminar AND (nuclei OR nucleus)),("Straight gyrus" OR "gyrus rectus"),1,1099,129,1228,0.000814332247557
(Dorsomedial AND hypothal*),"Paracentral lobule",0,2139,65,2204,0.0
"Dorsolateral prefrontal",Temporoparietal,17,2987,1443,4430,0.0038374717833
"Angular gyrus","Primary auditory",4,498,1865,2363,0.00169276343631
"Dorsolateral prefrontal","Lateral geniculate",1,3003,5179,8182,0.000122219506233
"Broca's area","Lingual gyrus",4,690,250,940,0.00425531914894
Cingulum,(Cochlear AND (nuclei OR nucleus)),1,684,5306,5990,0.00016694490818
("Gustatory cortex" OR "gustatory area"),("Ventral posterolateral" AND (nuclei OR nucleus)),0,153,148,301,0.0
Cingulum,Pulvinar,3,682,1130,1812,0.00165562913907
"Dentate gyrus","Posterior parahippocampal gyrus",0,11443,41,11484,0.0
(Inferior AND collicul*),(Periventricular AND (nuclei OR nucleus)),36,4247,2459,6706,0.00536832687146
"Inferior frontal",Subiculum,170,2642,98071,100713,0.0016879648109
Fusiform,"Ventral tegmentum",1,5454,284,5738,0.000174276751481
"Inferior temporal",(Periventricular AND (nuclei OR nucleus)),1,1710,2494,4204,0.00023786869648
"Indusium griseum",("Inferior olive" OR "Inferior olivary"),2,75,2378,2453,0.000815328169588
"Inferior temporal",(Superior AND collicul*),11,1700,10073,11773,0.000934341289391
"Lingual gyrus","Substantia nigra",0,254,19387,19641,0.0
"Globus pallidus",periaqueductal,81,8025,4495,12520,0.0064696485623
"Lingual gyrus",Thalamus,46,208,42836,43044,0.00106867391506
"Interstitial nucleus","Zona incerta",28,486,946,1432,0.0195530726257
"Lingual gyrus",Pineal,0,254,14403,14657,0.0
"Inferior frontal",Operculum,73,2739,853,3592,0.0203229398664
"Inferior frontal","Pontine nuclei",1,2811,797,3608,0.000277161862528
("Medial dorsal" AND nucl*),Striatum,15,98,58925,59023,0.000254138217305
Infralimbic,"Visual cortex",6,490,22874,23364,0.000256805341551
periaqueductal,"Substantia nigra",344,4232,19043,23275,0.0147798066595
"Pontine nuclei","Posterior parietal",7,791,2147,2938,0.00238257317903
Pons,("Ventral posteromedial" AND (nuclei OR nucleus)),13,25571,99,25670,0.000506427736658
"Middle frontal","Zona incerta",0,1028,974,2002,0.0
(Medulla OR "medulla oblongata"),Striatum,1693,49129,57247,106376,0.01591524404
Operculum,Premotor,69,857,4660,5517,0.0125067971724
"Olfactory bulb",(Septal AND (nuclei OR nucleus)),248,10963,4412,15375,0.0161300813008
"Nucleus accumbens",Pulvinar,4,12541,1129,13670,0.000292611558157
"Olfactory bulb",Thalamus,772,10439,42110,52549,0.0146910502579
"Nucleus basalis","Pontine nuclei",7,1840,791,2631,0.00266058532877
"Primary sensory",(Raphe AND (nuclei OR nucleus)),11,2999,8310,11309,0.000972676629233
Premotor,("Straight gyrus" OR "gyrus rectus"),1,4728,129,4857,0.000205888408483
(Periventricular AND (nuclei OR nucleus)),Pulvinar,3,2492,1130,3622,0.000828271673109
"Primary sensory",("Ventral posteromedial" AND (nuclei OR nucleus)),2,3008,110,3118,0.000641436818473
Striatum,"Superior temporal",101,58839,4006,62845,0.00160712864985
Prefrontal,"Primary sensory",82,24019,2928,26947,0.00304301035366
Subiculum,"Superior temporal",330,97911,3777,101688,0.00324522067501
(Raphe AND (nuclei OR nucleus)),("Superior olive" OR "superior olivary"),46,8275,1211,9486,0.00484925152857
"Inferior frontal",(Inferior AND collicul*),8,2804,4275,7079,0.00113010312191
"Calcarine fissure",Cingulate,8,95,11096,11191,0.000714860155482
"Anterior cingulate","Middle frontal",192,5610,836,6446,0.029785913745
"Anterior cingulate","Paracentral lobule",9,5793,56,5849,0.0015387245683
Cerebellum,"Middle frontal",127,65273,901,66174,0.0019191827606
(Cochlear AND (nuclei OR nucleus)),"Superior frontal",0,5307,1091,6398,0.0
"Lateral geniculate",Premotor,7,5173,4722,9895,0.000707427993936
("Centromedian" AND (nuclei OR nucleus)),Striatum,64,152,58876,59028,0.00108423121231
"Dorsolateral prefrontal","Ventral tegmentum",0,3004,285,3289,0.0
Cingulate,"Globus pallidus",194,10910,7912,18822,0.0103070874509
"Amygdala","Broca's area",12,23345,682,24027,0.000499438132101
"Amygdala",Cerebellum,1230,22127,64170,86297,0.0142531026571
"Calcarine fissure",Precuneus,1,102,1219,1321,0.000757002271007
"Basal forbrain",Premotor,0,1,4729,4730,0.0
("Heschl's gyrus" OR "Transverse temporal"),Subiculum,76,1072,98165,99237,0.000765843385028
("Centromedian" AND (nuclei OR nucleus)),Hippocamp*,20,196,104074,104270,0.000191809724753
Claustrum,"Paracentral lobule",5,82736,60,82796,6.03893907918e-05
(Cochlear AND (nuclei OR nucleus)),Hypothalam*,114,5193,107435,112628,0.00101218169549
"Indusium griseum",Temporoparietal,0,77,1460,1537,0.0
Hypothalam*,"Nucleus basalis",139,107410,1708,109118,0.00127385032717
(Inferior AND collicul*),"Nucleus basalis",5,4278,1842,6120,0.000816993464052
("Inferior olive" OR "Inferior olivary"),Precuneus,2,2378,1218,3596,0.00055617352614
("Inferior olive" OR "Inferior olivary"),("Straight gyrus" OR "gyrus rectus"),0,2380,130,2510,0.0
Hippocamp*,Orbitofrontal,387,103707,2609,106316,0.0036400918018
Hippocamp*,Operculum,30,104064,896,104960,0.000285823170732
(Intralaminar AND (nuclei OR nucleus)),"Medial geniculate",81,1019,1168,2187,0.037037037037
"Inferior temporal",Pulvinar,21,1690,1112,2802,0.00749464668094
"Nucleus basalis",Striatum,275,1572,58665,60237,0.00456530039677
("Nucleus gracilis" OR "gracile nucleus"),"Ventromedial prefrontal",0,374,3,377,0.0
"Inferior frontal",Pulvinar,14,2798,1119,3917,0.00357416390094
("Nucleus gracilis" OR "gracile nucleus"),("Ventral posteromedial" AND (nuclei OR nucleus)),0,374,112,486,0.0
periaqueductal,("Superior olive" OR "superior olivary"),17,4559,1240,5799,0.00293153992068
Insula*,"Nucleus basalis",24,17149,1823,18972,0.00126502213789
Infralimbic,("Ventral posterior" AND (nuclei OR nucleus)),2,494,354,848,0.00235849056604
(Medulla OR "medulla oblongata"),("Superior olive" OR "superior olivary"),754,50068,503,50571,0.0149097308734
"Postcentral gyrus",Striatum,10,521,58930,59451,0.000168205749273
"Nucleus basalis","Nucleus accumbens",61,1786,12484,14270,0.00427470217239
"Medial frontal","Posterior parahippocampal gyrus",0,1595,41,1636,0.0
"Paracentral lobule",Subiculum,3,62,98238,98300,3.0518819939e-05
Pons,(Raphe AND (nuclei OR nucleus)),1150,24434,7171,31605,0.0363866476823
"Posterior parahippocampal gyrus",Prefrontal,6,35,24095,24130,0.000248653128885
Prefrontal,"Visual cortex",566,23535,22314,45849,0.0123448712077
"Middle frontal",Precuneus,115,913,1105,2018,0.0569871159564
(Septal AND (nuclei OR nucleus)),"Wernicke's area",0,4660,251,4911,0.0
"Middle frontal",("Red nucleus"),0,1028,2376,3404,0.0
(Septal AND (nuclei OR nucleus)),("Red nucleus"),32,4628,2344,6972,0.00458978772232
"Piriform cortex",Striatum,192,1551,58748,60299,0.00318413240684
("Ventral posterior" AND (nuclei OR nucleus)),"Visual cortex",6,350,22874,23224,0.000258353427489
Pulvinar,Subgranular,0,1133,632,1765,0.0
Putamen,"Superior frontal",57,10692,1034,11726,0.00486099266587
"Anterior cingulate","Nucleus basalis",10,5792,1837,7629,0.00131078778346
"Basal forbrain",Cingulum,0,1,685,686,0.0
Cerebellum,"Primary auditory",31,65369,1838,67207,0.000461261475739
(Cochlear AND (nuclei OR nucleus)),Subthalam*,14,5293,4115,9408,0.0014880952381
"Diagonal band of Broca","Postcentral gyrus",0,895,531,1426,0.0
"Diagonal band of Broca",Thalamus,96,799,42786,43585,0.00220259263508
"Dorsolateral prefrontal","Stria terminalis",3,3001,2727,5728,0.00052374301676
Ambiguus,("Ventral posterolateral" AND (nuclei OR nucleus)),0,1216,148,1364,0.0
"Amygdala",Claustrum,14949,8408,67792,76200,0.196181102362
"Calcarine fissure",("Superior olive" OR "superior olivary"),0,103,1257,1360,0.0
"Broca's area",("Ventral posterior" AND (nuclei OR nucleus)),0,694,356,1050,0.0
("Centromedian" AND (nuclei OR nucleus)),Cerebellum,12,204,65388,65592,0.000182949140139
Cingulum,("Locus coeruleus" OR "locus ceruleus"),9,676,7630,8306,0.00108355405731
Cingulum,Premotor,12,673,4717,5390,0.00222634508349
(Cochlear AND (nuclei OR nucleus)),"Inferior frontal",0,5307,2812,8119,0.0
Entorhinal,("Superior olive" OR "superior olivary"),3,5544,1254,6798,0.000441306266549
Fusiform,Subiculum,293,5162,97948,103110,0.00284162544855
("Inferior olive" OR "Inferior olivary"),"Supplementary motor",5,2375,2356,4731,0.00105685901501
("Inferior olive" OR "Inferior olivary"),"Inferior frontal",1,2379,2811,5190,0.00019267822736
"Inferior temporal","Medial frontal",32,1679,1563,3242,0.0098704503393
Hippocamp*,"Postcentral gyrus",41,104053,490,104543,0.000392183120821
"Interstitial nucleus","Stria terminalis",48,466,2682,3148,0.0152477763659
"Medial geniculate","Middle frontal",1,1248,1027,2275,0.00043956043956
"Nucleus accumbens",("Ventral posterolateral" AND (nuclei OR nucleus)),2,12543,146,12689,0.000157616833478
"Pontine nuclei",("Ventral posterolateral" AND (nuclei OR nucleus)),3,795,145,940,0.0031914893617
"Posterior parahippocampal gyrus",Precuneus,1,40,1219,1259,0.000794281175536
("Posterior nucleus" AND hypothalamus),"Substantia nigra",4,63,19383,19446,0.000205697829888
"Posterior cingulate","Superior frontal",70,1832,1021,2853,0.024535576586
Premotor,"Superior temporal",220,4509,3887,8396,0.0262029537875
Premotor,("Superior olive" OR "superior olivary"),4,4725,1253,5978,0.000669120107059
"Middle temporal",("Ventral posteromedial" AND (nuclei OR nucleus)),0,1637,112,1749,0.0
"Stria terminalis",("Ventral posterior" AND (nuclei OR nucleus)),5,2725,351,3076,0.00162548764629
"Piriform cortex",(Superior AND collicul*),47,1696,10037,11733,0.00400579561919
("Superior olive" OR "superior olivary"),"Thalamic reticular",1,1256,599,1855,0.000539083557951
Pulvinar,Thalamus,899,234,41983,42217,0.0212947390862
Subthalam*,"Ventral tegmentum",4,4125,281,4406,0.000907852927826
Putamen,Striatum,6139,4610,52801,57411,0.106930727561
"Primary motor","Zona incerta",4,3201,970,4171,0.000959002637257
"Anterior cingulate","Angular gyrus",44,5758,458,6216,0.00707850707851
"Lateral geniculate",(Medulla OR "medulla oblongata"),67,5113,50755,55868,0.0011992553877
"Basal forbrain","Calcarine fissure",0,1,103,104,0.0
(Cochlear AND (nuclei OR nucleus)),("Ventral posterior" AND (nuclei OR nucleus)),1,5306,355,5661,0.000176647235471
"Diagonal band of Broca",Entorhinal,38,857,5509,6366,0.00596921143575
"Lateral geniculate","Visual extrastriate",89,5091,1445,6536,0.0136168910649
"Lateral geniculate",("Ventral posterior" AND (nuclei OR nucleus)),30,5150,326,5476,0.0054784514244
Fusiform,("Nucleus gracilis" OR "gracile nucleus"),3,5452,371,5823,0.000515198351365
"Globus pallidus",("Ventral posterolateral" AND (nuclei OR nucleus)),5,8101,143,8244,0.000606501698205
("Gustatory cortex" OR "gustatory area"),Hippocamp*,14,139,104080,104219,0.000134332511346
("Heschl's gyrus" OR "Transverse temporal"),"Primary sensory",5,1143,3005,4148,0.00120540019286
"Broca's area","Superior frontal",12,682,1079,1761,0.00681431005111
"Calcarine fissure",("Ventral posterolateral" AND (nuclei OR nucleus)),0,103,148,251,0.0
Cingulate,"Visual extrastriate",55,11049,1479,12528,0.0043901660281
Claustrum,"Postcentral gyrus",30,82711,501,83212,0.00036052492429
("Gustatory cortex" OR "gustatory area"),"Visual cortex",2,151,22878,23029,8.68470189761e-05
(Cochlear AND (nuclei OR nucleus)),"Medial frontal",0,5307,1595,6902,0.0
"Inferior frontal","Superior frontal",248,2564,843,3407,0.0727913120047
"Inferior parietal lobule",(Intralaminar AND (nuclei OR nucleus)),5,791,1095,1886,0.00265111346766
"Inferior parietal lobule","Substantia nigra",3,793,19384,20177,0.000148684145314
Hypothalam*,"Indusium griseum",20,107529,57,107586,0.000185897793393
"Medial frontal",("Nucleus cuneatus" OR "cuneate nucleus"),0,1595,692,2287,0.0
("Medial dorsal" AND nucl*),"Superior frontal",0,113,1091,1204,0.0
periaqueductal,Precuneus,5,4571,1215,5786,0.00086415485655
("Nucleus cuneatus" OR "cuneate nucleus"),("Red nucleus"),25,667,2351,3018,0.00828363154407
(Medulla OR "medulla oblongata"),"Middle temporal",3,50819,1634,52453,5.71940594437e-05
"Middle frontal","Ventral tegmentum",0,1028,285,1313,0.0
(Medulla OR "medulla oblongata"),Pulvinar,18,50804,1115,51919,0.000346693888557
"Pontine nuclei",Pulvinar,15,783,1118,1901,0.00789058390321
"Piriform cortex","Visual cortex",11,1732,22869,24601,0.000447136295273
"Postcentral gyrus","Ventromedial prefrontal",0,531,3,534,0.0
"Paracentral lobule",Pulvinar,0,65,1133,1198,0.0
Premotor,(Raphe AND (nuclei OR nucleus)),73,4656,8248,12904,0.00565716057037
"Middle frontal","Nucleus basalis",2,1026,1845,2871,0.000696621386277
Premotor,"Stria terminalis",6,4723,2724,7447,0.00080569356788
"Primary auditory",Putamen,14,1855,10735,12590,0.00111199364575
"Paracentral lobule","Ventral tegmentum",0,65,285,350,0.0
"Primary motor","Primary auditory",15,3190,1854,5044,0.00297383029342
Premotor,"Wernicke's area",13,4716,238,4954,0.00262414210739
"Supplementary motor",("Ventral posteromedial" AND (nuclei OR nucleus)),0,2361,112,2473,0.0
Pulvinar,Striatum,69,1064,58871,59935,0.00115124718445
("Ventral posterior" AND (nuclei OR nucleus)),("Ventral anterior" AND (nuclei OR nucleus)),23,333,214,547,0.0420475319927
Prefrontal,"Stria terminalis",119,23982,2611,26593,0.00447486180574
"Anterior cingulate","Primary sensory",30,5772,2980,8752,0.00342778793419
(Intralaminar AND (nuclei OR nucleus)),Premotor,27,1073,4702,5775,0.00467532467532
(Dorsomedial AND hypothal*),Subthalam*,28,2111,4101,6212,0.00450740502254
"Dorsolateral prefrontal",(Septal AND (nuclei OR nucleus)),2,3002,4658,7660,0.000261096605744
Cingulate,("Heschl's gyrus" OR "Transverse temporal"),32,11072,1116,12188,0.00262553331145
"Broca's area","Inferior frontal",166,528,2646,3174,0.052299936988
("Heschl's gyrus" OR "Transverse temporal"),(Periventricular AND (nuclei OR nucleus)),1,1147,2494,3641,0.000274649821478
("Gustatory cortex" OR "gustatory area"),("Straight gyrus" OR "gyrus rectus"),0,153,130,283,0.0
(Inferior AND collicul*),"Lateral geniculate",105,4178,5075,9253,0.0113476710256
"Dentate gyrus","Postcentral gyrus",0,11443,531,11974,0.0
"Indusium griseum",("Posterior nucleus" AND hypothalamus),0,77,67,144,0.0
Hypothalam*,"Posterior parahippocampal gyrus",1,107548,40,107588,9.29471688292e-06
"Inferior temporal",Putamen,39,1672,10710,12382,0.00314973348409
"Inferior temporal","Primary auditory",7,1704,1862,3566,0.00196298373528
"Interstitial nucleus","Visual extrastriate",1,513,1533,2046,0.000488758553275
("Mammillary body" OR "Mammillary bodies),"Middle frontal",30,30,1027,1057,0.0283822138127
("Mammillary body" OR "Mammillary bodies),Precuneus,1,1368,1219,2587,0.000386548125242
("Nucleus cuneatus" OR "cuneate nucleus"),Subgranular,0,692,632,1324,0.0
"Piriform cortex","Wernicke's area",0,1743,251,1994,0.0
("Posterior nucleus" AND hypothalamus),("Ventral posteromedial" AND (nuclei OR nucleus)),1,66,111,177,0.00564971751412
Pons,"Superior frontal",17,25567,1074,26641,0.000638114184903
Perirhinal,"Ventromedial prefrontal",0,1200,3,1203,0.0
"Primary sensory",Temporoparietal,3,3007,1457,4464,0.000672043010753
"Middle frontal",Orbitofrontal,65,963,2931,3894,0.0166923472008
"Stria terminalis",(Superior AND collicul*),87,2643,9997,12640,0.00688291139241
"Middle temporal","Posterior cingulate",98,1539,1804,3343,0.029314986539
"Superior temporal","Visual extrastriate",120,3987,1414,5401,0.0222181077578
"Thalamic reticular",("Ventral anterior" AND (nuclei OR nucleus)),5,595,232,827,0.00604594921403
"Substantia nigra",Subthalam*,933,18454,3196,21650,0.0430946882217
Prefrontal,(Raphe AND (nuclei OR nucleus)),321,23780,8000,31780,0.0101006922593
Ambiguus,(Periventricular AND (nuclei OR nucleus)),22,1194,2473,3667,0.00599945459504
(Cochlear AND (nuclei OR nucleus)),(Raphe AND (nuclei OR nucleus)),85,5222,8236,13458,0.00631594590578
Fusiform,"Lingual gyrus",68,5387,186,5573,0.0122016867038
Entorhinal,Infralimbic,57,5490,439,5929,0.00961376286052
"Basal forbrain",Orbitofrontal,0,1,2996,2997,0.0
Caudate,"Middle temporal",54,18747,1583,20330,0.00265617314314
Cingulate,Prefrontal,3673,7431,20428,27859,0.131842492552
Cingulate,Suprachiasmatic,43,11061,5983,17044,0.00252288195259
Hypothalam*,"Middle temporal",17,107532,1620,109152,0.000155746115509
Fusiform,"Visual extrastriate",131,5324,1403,6727,0.0194737624498
"Globus pallidus",Perirhinal,16,8090,1184,9274,0.00172525339659
"Globus pallidus","Primary auditory",7,8099,1862,9961,0.000702740688686
Hippocamp*,"Lateral geniculate",195,103899,4985,108884,0.00179089673414
"Inferior temporal","Primary motor",11,1700,3194,4894,0.0022476501839
Hippocamp*,Putamen,1850,102244,8899,111143,0.0166452228211
"Interstitial nucleus","Substantia nigra",22,492,19365,19857,0.00110792163972
"Lingual gyrus","Visual cortex",27,227,22853,23080,0.0011698440208
("Medial dorsal" AND nucl*),"Superior temporal",7,106,4100,4206,0.00166428911079
("Mammillary body" OR "Mammillary bodies),Subthalam*,19,1350,4110,5460,0.00347985347985
"Medial geniculate",Thalamus,968,281,41914,42195,0.0229411067662
(Medulla OR "medulla oblongata"),Prefrontal,99,50723,24002,74725,0.00132485781198
"Pontine nuclei","Visual extrastriate",7,791,1527,2318,0.0030198446937
"Olfactory bulb",Temporoparietal,1,11210,1459,12669,7.89328281632e-05
"Paracentral lobule",Premotor,3,62,4726,4788,0.00062656641604
"Posterior parahippocampal gyrus",Subgranular,0,41,632,673,0.0
Premotor,Temporoparietal,26,4703,1434,6137,0.00423659768617
"Primary sensory",("Straight gyrus" OR "gyrus rectus"),0,3010,130,3140,0.0
(Septal AND (nuclei OR nucleus)),Subthalam*,43,4617,4086,8703,0.00494082500287
"Stria terminalis",("Ventral posterolateral" AND (nuclei OR nucleus)),1,2729,147,2876,0.000347705146036
"Superior temporal",Temporoparietal,73,4034,1387,5421,0.0134661501568
Precuneus,("Ventral anterior" AND (nuclei OR nucleus)),2,1218,235,1453,0.0013764624914
("Ventral posterolateral" AND (nuclei OR nucleus)),"Ventromedial prefrontal",0,148,3,151,0.0
"Supplementary motor",("Ventral posterolateral" AND (nuclei OR nucleus)),1,2360,147,2507,0.000398883127244
Pulvinar,"Wernicke's area",0,1133,251,1384,0.0
"Medial geniculate",Perirhinal,24,1225,1176,2401,0.00999583506872
Subthalam*,("Ventral anterior" AND (nuclei OR nucleus)),28,4101,209,4310,0.00649651972158
Subiculum,"Supplementary motor",63,98178,2298,100476,0.000627015406664
"Amygdala","Superior temporal",299,23058,3808,26866,0.0111293084196
(Intralaminar AND (nuclei OR nucleus)),(Periventricular AND (nuclei OR nucleus)),29,1071,2466,3537,0.00819903873339
"Lateral geniculate",("Locus coeruleus" OR "locus ceruleus"),85,5095,7554,12649,0.00671989880623
Cerebellum,("Inferior olive" OR "Inferior olivary"),1309,64091,1071,65162,0.0200883950769
(Cochlear AND (nuclei OR nucleus)),("Ventral posteromedial" AND (nuclei OR nucleus)),0,5307,112,5419,0.0
"Dorsolateral prefrontal","Inferior parietal lobule",58,2946,738,3684,0.0157437567861
"Diagonal band of Broca",Suprachiasmatic,63,832,5963,6795,0.00927152317881
("Gustatory cortex" OR "gustatory area"),"Medial geniculate",1,152,1248,1400,0.000714285714286
Fusiform,Premotor,62,5393,4667,10060,0.00616302186879
Entorhinal,"Lateral geniculate",14,5533,5166,10699,0.0013085335078
("Gustatory cortex" OR "gustatory area"),periaqueductal,0,153,4576,4729,0.0
"Calcarine fissure","Posterior parietal",0,103,2154,2257,0.0
("Heschl's gyrus" OR "Transverse temporal"),Subthalam*,1,1147,4128,5275,0.000189573459716
"Broca's area","Ventromedial prefrontal",0,694,3,697,0.0
"Dentate gyrus","Interstitial nucleus",4,11439,510,11949,0.000334756046531
(Cochlear AND (nuclei OR nucleus)),Infralimbic,0,5307,496,5803,0.0
"Globus pallidus","Inferior frontal",24,8082,2788,10870,0.00220791168353
"Interstitial nucleus",Subthalam*,17,497,4112,4609,0.00368843566934
"Interstitial nucleus","Thalamic reticular",0,514,600,1114,0.0
Hypothalam*,Hippocamp*,8946,98603,95148,193751,0.0461726649153
("Nucleus cuneatus" OR "cuneate nucleus"),Temporoparietal,0,692,1460,2152,0.0
("Nucleus cuneatus" OR "cuneate nucleus"),Pulvinar,1,691,1132,1823,0.000548546352167
("Medial dorsal" AND nucl*),(Periventricular AND (nuclei OR nucleus)),2,111,2493,2604,0.000768049155146
Parahippocamp*,Prefrontal,494,2165,23607,25772,0.0191680893993
Infralimbic,Subiculum,132,364,98109,98473,0.00134046896104
Infralimbic,Temporoparietal,0,496,1460,1956,0.0
Infralimbic,("Ventral posterolateral" AND (nuclei OR nucleus)),0,496,148,644,0.0
"Medial frontal",("Superior olive" OR "superior olivary"),0,1595,1257,2852,0.0
"Paracentral lobule",Orbitofrontal,3,62,2993,3055,0.000981996726678
("Posterior nucleus" AND hypothalamus),"Wernicke's area",0,67,251,318,0.0
("Posterior nucleus" AND hypothalamus),Striatum,3,64,58937,59001,5.08465958204e-05
Premotor,Subthalam*,65,4664,4064,8728,0.00744729605866
(Periventricular AND (nuclei OR nucleus)),("Ventral posterior" AND (nuclei OR nucleus)),8,2487,348,2835,0.00282186948854
("Straight gyrus" OR "gyrus rectus"),("Ventral anterior" AND (nuclei OR nucleus)),1,129,236,365,0.0027397260274
(Septal AND (nuclei OR nucleus)),"Ventral tegmentum",10,4650,275,4925,0.00203045685279
"Stria terminalis",("Straight gyrus" OR "gyrus rectus"),2,2728,128,2856,0.000700280112045
"Posterior parietal","Primary sensory",19,2135,2991,5126,0.00370659383535
("Red nucleus"),(Raphe AND (nuclei OR nucleus)),139,2237,8182,10419,0.0133410116134
(Raphe AND (nuclei OR nucleus)),"Substantia nigra",870,7451,18517,25968,0.0335027726433
("Nucleus gracilis" OR "gracile nucleus"),Thalamus,54,320,42828,43148,0.00125150644294
Cerebellum,"Thalamic reticular",30,65370,570,65940,0.000454959053685
("Centromedian" AND (nuclei OR nucleus)),"Superior temporal",0,216,4107,4323,0.0
Cingulate,"Posterior parahippocampal gyrus",7,11097,34,11131,0.000628874314976
Cerebellum,(Dorsomedial AND hypothal*),81,65319,2058,67377,0.00120219065853
(Dorsomedial AND hypothal*),"Stria terminalis",254,1885,2476,4361,0.058243522128
(Dorsomedial AND hypothal*),Striatum,94,2045,58846,60891,0.00154374209653
"Globus pallidus","Superior frontal",16,8090,1075,9165,0.00174577195854
Cingulum,"Inferior frontal",14,671,2798,3469,0.00403574517152
(Dorsomedial AND hypothal*),"Wernicke's area",0,2139,251,2390,0.0
Cingulum,"Primary auditory",1,684,1868,2552,0.000391849529781
(Cochlear AND (nuclei OR nucleus)),"Pontine nuclei",43,5264,755,6019,0.00714404386111
(Inferior AND collicul*),"Postcentral gyrus",1,4282,530,4812,0.000207813798836
"Inferior parietal lobule",Operculum,24,772,902,1674,0.0143369175627
Hypothalam*,"Wernicke's area",0,107549,251,107800,0.0
Hippocamp*,("Ventral posterior" AND (nuclei OR nucleus)),15,104079,341,104420,0.00014365064164
("Nucleus cuneatus" OR "cuneate nucleus"),Thalamus,126,566,42756,43322,0.00290845298001
Hippocamp*,Subgranular,505,103589,127,103716,0.00486906552509
Insula*,"Ventromedial prefrontal",0,17173,3,17176,0.0
(Inferior AND collicul*),("Red nucleus"),76,4207,2300,6507,0.0116797295221
("Nucleus gracilis" OR "gracile nucleus"),"Piriform cortex",1,373,1742,2115,0.000472813238771
periaqueductal,"Postcentral gyrus",1,4575,530,5105,0.000195886385896
periaqueductal,"Visual cortex",22,4554,22858,27412,0.000802568218299
Insula*,("Nucleus gracilis" OR "gracile nucleus"),1,17172,373,17545,5.69962952408e-05
"Olfactory bulb","Postcentral gyrus",0,11211,531,11742,0.0
Pons,"Primary auditory",45,25539,1824,27363,0.00164455651793
"Paracentral lobule","Wernicke's area",1,64,250,314,0.0031847133758
"Paracentral lobule",("Ventral anterior" AND (nuclei OR nucleus)),0,65,237,302,0.0
"Posterior cingulate",Subiculum,367,1535,97874,99409,0.00369181864821
(Periventricular AND (nuclei OR nucleus)),Precuneus,1,2494,1219,3713,0.000269323996768
(Periventricular AND (nuclei OR nucleus)),"Piriform cortex",36,2459,1707,4166,0.00864138262122
"Stria terminalis","Thalamic reticular",5,2725,595,3320,0.00150602409639
"Posterior parietal","Visual cortex",182,1972,22698,24670,0.00737738143494
("Superior olive" OR "superior olivary"),"Ventromedial prefrontal",0,1257,3,1260,0.0
"Superior temporal","Visual cortex",392,3715,22488,26203,0.0149601190703
(Superior AND collicul*),("Ventral anterior" AND (nuclei OR nucleus)),11,10073,226,10299,0.00106806486067
"Posterior parietal","Supplementary motor",122,2032,2239,4271,0.028564738937
"Zona incerta","Wernicke's area",0,974,251,1225,0.0
Putamen,"Stria terminalis",172,10577,2558,13135,0.0130947849258
Ambiguus,"Dentate gyrus",10,1206,11433,12639,0.000791201835588
"Amygdala",("Mammillary body" OR "Mammillary bodies),135,23222,135,23357,0.00577985186454
Cingulate,(Inferior AND collicul*),57,11047,4226,15273,0.00373207621292
Cerebellum,"Postcentral gyrus",72,65328,459,65787,0.00109444115099
"Calcarine fissure",("Heschl's gyrus" OR "Transverse temporal"),3,100,1145,1245,0.00240963855422
"Angular gyrus",("Straight gyrus" OR "gyrus rectus"),2,500,128,628,0.0031847133758
Cingulate,"Lingual gyrus",86,11018,168,11186,0.00768818165564
Cingulate,Claustrum,1671,9433,81070,90503,0.0184634763489
"Dorsolateral prefrontal",Suprachiasmatic,0,3004,6026,9030,0.0
"Dentate gyrus",Hippocamp*,10028,1415,94066,95481,0.105026130853
"Lateral geniculate","Posterior cingulate",2,5178,1900,7078,0.000282565696524
(Dorsomedial AND hypothal*),Suprachiasmatic,357,1782,5669,7451,0.0479130318078
Cingulate,"Posterior cingulate",1902,9202,0,9202,0.206694196914
"Diagonal band of Broca",Operculum,1,894,925,1819,0.000549752611325
"Dorsolateral prefrontal","Medial geniculate",0,3004,1249,4253,0.0
"Basal forbrain","Middle temporal",0,1,1637,1638,0.0
("Centromedian" AND (nuclei OR nucleus)),("Mammillary body" OR "Mammillary bodies),1,215,1,216,0.00462962962963
Cingulum,("Heschl's gyrus" OR "Transverse temporal"),3,682,1145,1827,0.00164203612479
"Calcarine fissure","Visual cortex",66,37,22814,22851,0.00288827622424
("Centromedian" AND (nuclei OR nucleus)),Orbitofrontal,3,213,2993,3206,0.00093574547723
("Heschl's gyrus" OR "Transverse temporal"),"Inferior parietal lobule",11,1137,785,1922,0.0057232049948
Hypothalam*,periaqueductal,1149,106400,3427,109827,0.0104619082739
(Cochlear AND (nuclei OR nucleus)),Entorhinal,11,5296,5536,10832,0.00101550960118
(Inferior AND collicul*),"Inferior temporal",11,4272,1700,5972,0.00184192900201
"Dentate gyrus","Ventromedial prefrontal",0,11443,3,11446,0.0
"Nucleus basalis",("Straight gyrus" OR "gyrus rectus"),2,1845,128,1973,0.00101368474404
("Mammillary body" OR "Mammillary bodies),"Wernicke's area",83,83,251,334,0.248502994012
"Inferior frontal","Inferior temporal",167,2645,1544,4189,0.0398663165433
periaqueductal,Pons,436,4140,25148,29288,0.0148866429937
("Nucleus gracilis" OR "gracile nucleus"),"Ventral tegmentum",0,374,285,659,0.0
Infralimbic,"Interstitial nucleus",2,494,512,1006,0.00198807157058
"Medial geniculate","Ventral tegmentum",2,1247,283,1530,0.00130718954248
Infralimbic,"Middle frontal",0,496,1028,1524,0.0
Infralimbic,("Red nucleus"),2,494,2374,2868,0.000697350069735
periaqueductal,"Ventral tegmentum",17,4559,268,4827,0.0035218562254
Parahippocamp*,("Superior olive" OR "superior olivary"),0,2659,1257,3916,0.0
"Pontine nuclei","Ventral tegmentum",0,798,285,1083,0.0
Insula*,"Posterior parietal",152,17021,2002,19023,0.00799032749829
"Nucleus accumbens","Stria terminalis",378,12167,2352,14519,0.026034850885
Pons,"Pontine nuclei",418,25166,380,25546,0.0163626399436
(Periventricular AND (nuclei OR nucleus)),Putamen,76,2419,10673,13092,0.00580507179957
"Primary sensory",Subthalam*,3,3007,4126,7133,0.000420580400953
"Posterior cingulate","Substantia nigra",14,1888,19373,21261,0.000658482667795
"Primary sensory","Ventromedial prefrontal",0,3010,3,3013,0.0
("Straight gyrus" OR "gyrus rectus"),Subthalam*,0,130,4129,4259,0.0
"Superior frontal",Subthalam*,6,1085,4123,5208,0.00115207373272
Suprachiasmatic,("Ventral anterior" AND (nuclei OR nucleus)),2,6024,235,6259,0.000319539862598
"Posterior parietal","Superior temporal",130,2024,3977,6001,0.0216630561573
Temporoparietal,"Zona incerta",0,1460,974,2434,0.0
"Primary motor",("Ventral anterior" AND (nuclei OR nucleus)),11,3194,226,3420,0.00321637426901
Subgranular,Temporoparietal,0,632,1460,2092,0.0
("Red nucleus"),Subthalam*,130,2246,3999,6245,0.0208166533227
(Periventricular AND (nuclei OR nucleus)),"Stria terminalis",323,2172,2407,4579,0.0705394190871
Ambiguus,("Nucleus gracilis" OR "gracile nucleus"),10,1206,364,1570,0.00636942675159
Ambiguus,(Inferior AND collicul*),27,1189,4256,5445,0.00495867768595
Cerebellum,"Medial frontal",109,65291,1486,66777,0.00163229854591
(Intralaminar AND (nuclei OR nucleus)),("Ventral posterolateral" AND (nuclei OR nucleus)),7,1093,141,1234,0.00567260940032
"Lateral geniculate",(Septal AND (nuclei OR nucleus)),46,5134,4614,9748,0.00471891670086
"Lateral geniculate",Pineal,18,5162,14385,19547,0.000920857420576
(Intralaminar AND (nuclei OR nucleus)),("Red nucleus"),12,1088,2364,3452,0.00347624565469
"Lateral geniculate","Medial geniculate",116,5064,1133,6197,0.0187187348717
"Lateral geniculate",("Posterior nucleus" AND hypothalamus),9,5171,58,5229,0.00172117039587
"Lateral geniculate","Thalamic reticular",110,5070,490,5560,0.0197841726619
"Diagonal band of Broca",Insula*,15,880,17158,18038,0.000831577780242
Cingulate,"Indusium griseum",11,11093,66,11159,0.000985751411417
"Basal forbrain","Middle frontal",0,1,1028,1029,0.0
"Basal forbrain",Pineal,0,1,14403,14404,0.0
"Broca's area","Inferior temporal",20,674,1691,2365,0.00845665961945
"Broca's area",("Posterior nucleus" AND hypothalamus),0,694,67,761,0.0
"Broca's area",Caudate,21,673,18780,19453,0.001079525009
"Broca's area",Parahippocamp*,11,683,2648,3331,0.00330231161813
Cingulum,Infralimbic,1,684,495,1179,0.000848176420696
("Heschl's gyrus" OR "Transverse temporal"),"Posterior cingulate",6,1142,1896,3038,0.0019749835418
Claustrum,("Locus coeruleus" OR "locus ceruleus"),705,82036,6934,88970,0.00792401933236
Claustrum,Hypothalam*,6001,76740,101548,178288,0.0336590236023
Claustrum,"Medial geniculate",132,82609,1117,83726,0.00157657119652
Hypothalam*,(Septal AND (nuclei OR nucleus)),1336,106213,3324,109537,0.0121967919516
Hippocamp*,(Intralaminar AND (nuclei OR nucleus)),88,104006,1012,105018,0.000837951589251
("Inferior olive" OR "Inferior olivary"),("Medial dorsal" AND nucl*),5,2375,108,2483,0.00201369311317
"Inferior temporal","Olfactory bulb",3,1708,11208,12916,0.000232270052648
"Inferior temporal",("Nucleus gracilis" OR "gracile nucleus"),0,1711,374,2085,0.0
"Inferior parietal lobule",Subiculum,81,715,98160,98875,0.000819216182048
"Interstitial nucleus","Pontine nuclei",12,502,786,1288,0.00931677018634
Hippocamp*,"Lingual gyrus",36,104058,218,104276,0.000345237638575
("Nucleus cuneatus" OR "cuneate nucleus"),("Posterior nucleus" AND hypothalamus),1,691,66,757,0.00132100396301
("Medial dorsal" AND nucl*),"Pontine nuclei",3,110,795,905,0.00331491712707
"Olfactory bulb","Piriform cortex",427,10784,1316,12100,0.0352892561983
"Nucleus accumbens",(Raphe AND (nuclei OR nucleus)),413,12132,7908,20040,0.0206087824351
"Medial frontal",Subgranular,0,1595,632,2227,0.0
Pons,Pulvinar,38,25546,1095,26641,0.0014263728839
"Posterior parahippocampal gyrus","Substantia nigra",0,41,19387,19428,0.0
(Periventricular AND (nuclei OR nucleus)),"Posterior cingulate",2,2493,1900,4393,0.000455269747325
"Medial geniculate",Operculum,1,1248,925,2173,0.000460193281178
Ambiguus,(Dorsomedial AND hypothal*),28,1188,2111,3299,0.00848742043043
"Amygdala",("Locus coeruleus" OR "locus ceruleus"),738,22619,6901,29520,0.025
Ambiguus,Pineal,1,1215,14402,15617,6.40327847858e-05
Ambiguus,"Posterior parietal",0,1216,2154,3370,0.0
"Amygdala",Subgranular,16,23341,616,23957,0.000667863254999
"Angular gyrus",Caudate,20,482,18781,19263,0.00103825987645
"Angular gyrus",Orbitofrontal,16,486,2980,3466,0.00461627236007
"Anterior cingulate",("Ventral anterior" AND (nuclei OR nucleus)),14,5788,223,6011,0.0023290633838
Cerebellum,"Superior temporal",280,65120,3827,68947,0.00406109040277
(Intralaminar AND (nuclei OR nucleus)),"Ventromedial prefrontal",0,1100,3,1103,0.0
"Basal forbrain",Cingulate,0,1,11104,11105,0.0
"Lateral geniculate","Superior frontal",1,5179,1090,6269,0.000159515074175
"Dorsolateral prefrontal","Thalamic reticular",0,3004,600,3604,0.0
Cerebellum,(Intralaminar AND (nuclei OR nucleus)),49,65351,1051,66402,0.000737929580434
"Diagonal band of Broca","Primary motor",0,895,3205,4100,0.0
Fusiform,"Posterior cingulate",93,5362,1809,7171,0.0129689025241
"Globus pallidus","Ventral tegmentum",7,8099,278,8377,0.000835621344157
"Globus pallidus","Visual extrastriate",3,8103,1531,9634,0.000311397135146
Caudate,"Middle frontal",78,18723,950,19673,0.0039648248869
("Heschl's gyrus" OR "Transverse temporal"),(Medulla OR "medulla oblongata"),11,1137,50811,51948,0.00021175021175
Caudate,"Inferior parietal lobule",39,18762,757,19519,0.00199805317895
"Dentate gyrus","Middle frontal",3,11440,1025,12465,0.000240673886883
"Inferior frontal",Striatum,105,2707,58835,61542,0.00170615189627
"Inferior frontal",(Superior AND collicul*),7,2805,10077,12882,0.000543393882937
(Inferior AND collicul*),"Pontine nuclei",93,4190,705,4895,0.0189989785495
("Inferior olive" OR "Inferior olivary"),Infralimbic,2,2378,494,2872,0.000696378830084
("Mammillary body" OR "Mammillary bodies),(Periventricular AND (nuclei OR nucleus)),45,1324,2450,3774,0.0119236883943
("Nucleus cuneatus" OR "cuneate nucleus"),"Superior frontal",0,692,1091,1783,0.0
"Medial geniculate","Olfactory bulb",25,1224,11186,12410,0.00201450443191
"Medial geniculate",Pineal,8,1241,14395,15636,0.000511639805577
"Medial geniculate",periaqueductal,36,1213,4540,5753,0.00625760472797
Infralimbic,"Superior frontal",0,496,1091,1587,0.0
"Pontine nuclei","Thalamic reticular",6,792,594,1386,0.004329004329
"Paracentral lobule","Zona incerta",0,65,974,1039,0.0
"Posterior cingulate","Primary auditory",7,1895,1862,3757,0.0018631887144
"Middle temporal","Posterior parahippocampal gyrus",1,1636,40,1676,0.000596658711217
"Piriform cortex","Posterior parietal",1,1742,2153,3895,0.000256739409499
Pineal,("Ventral posterolateral" AND (nuclei OR nucleus)),0,14403,148,14551,0.0
"Posterior parietal","Visual extrastriate",60,2094,1474,3568,0.0168161434978
"Piriform cortex",("Ventral anterior" AND (nuclei OR nucleus)),1,1742,236,1978,0.000505561172902
"Superior frontal","Visual cortex",31,1060,22849,23909,0.00129658287674
"Inferior frontal",(Septal AND (nuclei OR nucleus)),1,2811,4659,7470,0.000133868808568
Ambiguus,Precuneus,0,1216,1220,2436,0.0
"Calcarine fissure",(Cochlear AND (nuclei OR nucleus)),0,103,5307,5410,0.0
"Anterior cingulate",("Medial dorsal" AND nucl*),9,5793,104,5897,0.00152619976259
Cerebellum,"Wernicke's area",7,65393,244,65637,0.000106647165471
"Dorsolateral prefrontal",(Periventricular AND (nuclei OR nucleus)),1,3003,2494,5497,0.000181917409496
"Dorsolateral prefrontal","Zona incerta",3,3001,971,3972,0.000755287009063
Fusiform,"Nucleus basalis",7,5448,1840,7288,0.00096048298573
(Dorsomedial AND hypothal*),Hippocamp*,230,1909,103864,105773,0.00217446796441
"Basal forbrain","Nucleus accumbens",0,1,12545,12546,0.0
Entorhinal,periaqueductal,44,5503,4532,10035,0.00438465371201
(Dorsomedial AND hypothal*),Pulvinar,9,2130,1124,3254,0.00276582667486
"Broca's area",(Intralaminar AND (nuclei OR nucleus)),0,694,1100,1794,0.0
("Gustatory cortex" OR "gustatory area"),"Paracentral lobule",0,153,65,218,0.0
("Heschl's gyrus" OR "Transverse temporal"),Putamen,5,1143,10744,11887,0.000420627576344
"Broca's area",("Ventral posterolateral" AND (nuclei OR nucleus)),0,694,148,842,0.0
("Heschl's gyrus" OR "Transverse temporal"),"Piriform cortex",0,1148,1743,2891,0.0
Cingulate,Precuneus,662,10442,558,11000,0.0601818181818
Claustrum,Subiculum,9780,72961,88461,161422,0.0605865371511
"Dentate gyrus","Zona incerta",28,11415,946,12361,0.00226518890057
Hypothalam*,Precuneus,12,107537,1208,108745,0.000110349901145
("Inferior olive" OR "Inferior olivary"),(Superior AND collicul*),169,2211,9915,12126,0.013936994887
"Globus pallidus",Hippocamp*,847,7259,103247,110506,0.00766474218594
"Globus pallidus","Indusium griseum",1,8105,76,8181,0.000122234445667
Hippocamp*,Subthalam*,191,103903,3938,107841,0.00177112600959
"Inferior parietal lobule",(Medulla OR "medulla oblongata"),2,794,50820,51614,3.874917658e-05
"Lingual gyrus","Paracentral lobule",3,251,62,313,0.00958466453674
("Mammillary body" OR "Mammillary bodies),Operculum,0,1369,926,2295,0.0
"Nucleus basalis","Primary sensory",7,1840,3003,4843,0.00144538509189
("Nucleus cuneatus" OR "cuneate nucleus"),"Visual cortex",1,691,22879,23570,4.24268137463e-05
("Medial dorsal" AND nucl*),"Posterior parahippocampal gyrus",0,113,41,154,0.0
"Olfactory bulb",Perirhinal,47,11164,1153,12317,0.00381586425266
(Medulla OR "medulla oblongata"),"Paracentral lobule",0,50822,65,50887,0.0
Parahippocamp*,"Thalamic reticular",1,2658,599,3257,0.000307031010132
Perirhinal,"Posterior parietal",16,1184,2138,3322,0.0048163756773
"Postcentral gyrus","Pontine nuclei",0,531,798,1329,0.0
Operculum,"Piriform cortex",3,923,1740,2663,0.00112654900488
("Locus coeruleus" OR "locus ceruleus"),(Superior AND collicul*),197,7442,9887,17329,0.0113682266721
"Postcentral gyrus","Visual cortex",13,518,22867,23385,0.000555911909344
"Paracentral lobule",periaqueductal,0,65,4576,4641,0.0
(Periventricular AND (nuclei OR nucleus)),("Ventral posteromedial" AND (nuclei OR nucleus)),1,2494,111,2605,0.000383877159309
"Middle temporal",Putamen,45,1592,10704,12296,0.0036597267404
"Piriform cortex","Superior temporal",4,1739,4103,5842,0.000684697021568
Precuneus,"Visual cortex",63,1157,22817,23974,0.00262784683407
Prefrontal,"Substantia nigra",430,23671,18957,42628,0.0100872665853
Cingulate,"Medial frontal",523,10581,1072,11653,0.0448811464859
"Calcarine fissure","Inferior frontal",0,103,2812,2915,0.0
("Centromedian" AND (nuclei OR nucleus)),"Posterior parahippocampal gyrus",0,216,41,257,0.0
(Intralaminar AND (nuclei OR nucleus)),Temporoparietal,2,1098,1458,2556,0.000782472613459
"Diagonal band of Broca","Indusium griseum",4,891,73,964,0.00414937759336
"Diagonal band of Broca",(Septal AND (nuclei OR nucleus)),276,619,4384,5003,0.0551668998601
(Dorsomedial AND hypothal*),"Posterior parietal",2,2137,2152,4289,0.000466309162975
"Broca's area",Hypothalam*,3,691,107546,108237,2.7716954461e-05
"Broca's area",(Cochlear AND (nuclei OR nucleus)),1,693,5306,5999,0.000166694449075
"Broca's area",Cingulum,3,691,682,1373,0.00218499635834
("Centromedian" AND (nuclei OR nucleus)),("Nucleus gracilis" OR "gracile nucleus"),0,216,374,590,0.0
(Cochlear AND (nuclei OR nucleus)),"Middle temporal",0,5307,1637,6944,0.0
Cingulum,"Superior temporal",24,661,4083,4744,0.00505902192243
Hypothalam*,("Nucleus cuneatus" OR "cuneate nucleus"),40,107509,652,108161,0.000369819066022
(Cochlear AND (nuclei OR nucleus)),"Primary motor",0,5307,3205,8512,0.0
"Globus pallidus","Lateral geniculate",30,8076,5150,13226,0.00226825948889
Entorhinal,"Zona incerta",16,5531,958,6489,0.00246571120358
"Globus pallidus","Olfactory bulb",153,7953,11058,19011,0.00804797222661
Hippocamp*,Premotor,118,103976,4611,108587,0.00108668625158
"Lingual gyrus",Subthalam*,1,253,4128,4381,0.000228258388496
("Nucleus cuneatus" OR "cuneate nucleus"),"Paracentral lobule",0,692,65,757,0.0
Infralimbic,"Nucleus basalis",2,494,1845,2339,0.000855066267636
("Nucleus cuneatus" OR "cuneate nucleus"),"Posterior cingulate",0,692,1902,2594,0.0
"Nucleus basalis","Superior temporal",13,1834,4094,5928,0.00219298245614
Infralimbic,("Straight gyrus" OR "gyrus rectus"),0,496,130,626,0.0
"Middle frontal","Visual cortex",37,991,22843,23834,0.00155240412856
Perirhinal,Putamen,37,1163,10712,11875,0.00311578947368
Insula*,Pulvinar,45,17128,1088,18216,0.00247035573123
Operculum,"Primary sensory",8,918,3002,3920,0.00204081632653
"Nucleus accumbens",Precuneus,7,12538,1213,13751,0.00050905388699
"Medial frontal",Temporoparietal,13,1582,1447,3029,0.00429184549356
Orbitofrontal,("Ventral anterior" AND (nuclei OR nucleus)),3,2993,234,3227,0.00092965602727
("Posterior nucleus" AND hypothalamus),Subgranular,0,67,632,699,0.0
("Straight gyrus" OR "gyrus rectus"),"Thalamic reticular",0,130,600,730,0.0
Temporoparietal,Thalamus,63,1397,42819,44216,0.00142482359327
"Primary motor","Ventromedial prefrontal",0,3205,3,3208,0.0
Thalamus,"Ventromedial prefrontal",0,42882,3,42885,0.0
Subiculum,"Superior frontal",110,98131,981,99112,0.00110985551699
"Angular gyrus",Subiculum,44,458,98197,98655,0.000445998682277
("Centromedian" AND (nuclei OR nucleus)),Pineal,0,216,14403,14619,0.0
(Dorsomedial AND hypothal*),("Nucleus gracilis" OR "gracile nucleus"),7,2132,367,2499,0.00280112044818
"Lateral geniculate","Primary motor",2,5178,3203,8381,0.000238635007756
(Cochlear AND (nuclei OR nucleus)),"Ventral tegmentum",0,5307,285,5592,0.0
"Diagonal band of Broca",("Gustatory cortex" OR "gustatory area"),0,895,153,1048,0.0
(Dorsomedial AND hypothal*),periaqueductal,187,1952,4389,6341,0.029490616622
"Diagonal band of Broca","Superior temporal",2,893,4105,4998,0.000400160064026
"Globus pallidus","Substantia nigra",2276,5830,17111,22941,0.0992110195719
("Gustatory cortex" OR "gustatory area"),Pineal,0,153,14403,14556,0.0
"Broca's area",("Nucleus gracilis" OR "gracile nucleus"),0,694,374,1068,0.0
("Centromedian" AND (nuclei OR nucleus)),(Dorsomedial AND hypothal*),5,211,2134,2345,0.00213219616205
Cingulate,("Red nucleus"),29,11075,2347,13422,0.00216063179854
(Inferior AND collicul*),("Medial dorsal" AND nucl*),4,4279,109,4388,0.000911577028259
Hypothalam*,Operculum,11,107538,915,108453,0.00010142642435
"Inferior parietal lobule","Primary sensory",3,793,3007,3800,0.000789473684211
"Inferior parietal lobule",("Nucleus gracilis" OR "gracile nucleus"),0,796,374,1170,0.0
"Interstitial nucleus",Premotor,36,478,4693,5171,0.00696190292013
"Lingual gyrus",Pulvinar,2,252,1131,1383,0.00144613159798
"Interstitial nucleus","Nucleus basalis",1,513,1846,2359,0.000423908435778
("Mammillary body" OR "Mammillary bodies),"Supplementary motor",1,1,2361,2362,0.000423370025402
("Nucleus gracilis" OR "gracile nucleus"),Putamen,3,371,10746,11117,0.000269856975803
("Nucleus gracilis" OR "gracile nucleus"),Pulvinar,0,374,1133,1507,0.0
"Medial geniculate","Zona incerta",37,1212,937,2149,0.0172173103769
periaqueductal,Premotor,54,4522,4675,9197,0.00587147983038
Parahippocamp*,"Supplementary motor",36,2623,2325,4948,0.00727566693614
periaqueductal,("Red nucleus"),90,4486,2286,6772,0.01329001772
"Pontine nuclei",Premotor,12,786,4717,5503,0.00218062874796
(Medulla OR "medulla oblongata"),"Thalamic reticular",10,50812,590,51402,0.00019454495934
"Pontine nuclei","Superior temporal",13,785,4094,4879,0.00266448042632
Operculum,("Red nucleus"),1,925,2375,3300,0.00030303030303
Orbitofrontal,Subthalam*,20,2976,4109,7085,0.00282286520819
("Posterior nucleus" AND hypothalamus),Prefrontal,3,64,24098,24162,0.000124161907127
("Posterior nucleus" AND hypothalamus),"Primary motor",0,67,3205,3272,0.0
Perirhinal,"Superior temporal",37,1163,4070,5233,0.00707051404548
"Primary auditory","Superior frontal",2,1867,1089,2956,0.000676589986468
"Primary auditory",Suprachiasmatic,1,1868,6025,7893,0.000126694539465
"Piriform cortex","Primary motor",4,1739,3201,4940,0.00080971659919
Prefrontal,Pulvinar,69,24032,1064,25096,0.00274944214217
Subiculum,("Ventral anterior" AND (nuclei OR nucleus)),11,98230,226,98456,0.000111725034533
periaqueductal,"Supplementary motor",16,4560,2345,6905,0.00231716147719
Ambiguus,("Mammillary body" OR "Mammillary bodies),2,1214,1367,2581,0.00077489345215
"Angular gyrus","Calcarine fissure",0,502,103,605,0.0
"Angular gyrus",(Cochlear AND (nuclei OR nucleus)),0,502,5307,5809,0.0
"Angular gyrus","Olfactory bulb",0,502,11211,11713,0.0
"Angular gyrus","Lateral geniculate",0,502,5180,5682,0.0
"Anterior cingulate",(Periventricular AND (nuclei OR nucleus)),14,5788,2481,8269,0.00169307050429
"Angular gyrus","Inferior temporal",43,459,1668,2127,0.0202162670428
"Basal forbrain","Dorsolateral prefrontal",0,1,3004,3005,0.0
"Lateral geniculate",Parahippocamp*,13,5167,2646,7813,0.00166389351082
"Dorsolateral prefrontal",("Heschl's gyrus" OR "Transverse temporal"),4,3000,1144,4144,0.000965250965251
"Diagonal band of Broca",Putamen,39,856,10710,11566,0.00337195227391
(Dorsomedial AND hypothal*),Entorhinal,36,2103,5511,7614,0.00472813238771
Entorhinal,"Medial frontal",29,5518,1566,7084,0.0040937323546
("Gustatory cortex" OR "gustatory area"),"Nucleus basalis",1,152,1846,1998,0.000500500500501
Caudate,Parahippocamp*,116,18685,2543,21228,0.00546448087432
("Centromedian" AND (nuclei OR nucleus)),"Indusium griseum",0,216,77,293,0.0
("Centromedian" AND (nuclei OR nucleus)),"Medial frontal",0,216,1595,1811,0.0
Claustrum,"Middle frontal",82,82659,946,83605,0.000980802583578
Cingulum,Subthalam*,3,682,4126,4808,0.000623960066556
("Gustatory cortex" OR "gustatory area"),"Superior temporal",4,149,4103,4252,0.000940733772342
Hypothalam*,Pons,2627,104922,22957,127879,0.0205428569194
"Dentate gyrus",("Straight gyrus" OR "gyrus rectus"),0,11443,130,11573,0.0
("Locus coeruleus" OR "locus ceruleus"),"Lingual gyrus",0,7639,254,7893,0.0
Insula*,Putamen,377,16796,10372,27168,0.0138766195524
("Mammillary body" OR "Mammillary bodies),"Posterior parahippocampal gyrus",2,2,41,43,0.046511627907
periaqueductal,"Posterior parahippocampal gyrus",0,4576,41,4617,0.0
Infralimbic,("Superior olive" OR "superior olivary"),0,496,1257,1753,0.0
"Middle temporal","Nucleus accumbens",7,1630,12538,14168,0.000494071146245
"Pontine nuclei","Stria terminalis",15,783,2715,3498,0.00428816466552
Operculum,"Visual cortex",34,892,22846,23738,0.00143230263712
"Medial frontal",(Superior AND collicul*),11,1584,10073,11657,0.000943639015184
("Locus coeruleus" OR "locus ceruleus"),Pons,4573,3066,21011,24077,0.189932300536
"Paracentral lobule",("Straight gyrus" OR "gyrus rectus"),0,65,130,195,0.0
Orbitofrontal,"Primary sensory",16,2980,2994,5974,0.00267827251423
("Posterior nucleus" AND hypothalamus),(Superior AND collicul*),9,58,10075,10133,0.000888187111418
"Posterior cingulate",Subgranular,0,1902,632,2534,0.0
Perirhinal,"Thalamic reticular",2,1198,598,1796,0.0011135857461
"Primary sensory",("Ventral posterior" AND (nuclei OR nucleus)),9,3001,347,3348,0.00268817204301
"Middle temporal",Prefrontal,235,1402,23866,25268,0.00930030077568
"Posterior parietal","Ventromedial prefrontal",0,2154,3,2157,0.0
"Thalamic reticular",("Ventral posterolateral" AND (nuclei OR nucleus)),2,598,146,744,0.00268817204301
"Posterior parietal",Suprachiasmatic,0,2154,6026,8180,0.0
"Piriform cortex",(Raphe AND (nuclei OR nucleus)),62,1681,8259,9940,0.00623742454728
Thalamus,"Zona incerta",402,42480,572,43052,0.00933754529406
"Substantia nigra",(Superior AND collicul*),695,18692,9389,28081,0.0247498308465
Infralimbic,"Paracentral lobule",0,496,65,561,0.0
"Amygdala",("Inferior olive" OR "Inferior olivary"),57,23300,2323,25623,0.0022245638684
"Anterior cingulate","Calcarine fissure",0,5802,103,5905,0.0
Cerebellum,("Posterior nucleus" AND hypothalamus),4,65396,63,65459,6.11069524435e-05
"Basal forbrain",("Locus coeruleus" OR "locus ceruleus"),0,1,7639,7640,0.0
(Cochlear AND (nuclei OR nucleus)),(Septal AND (nuclei OR nucleus)),32,5275,4628,9903,0.00323134403716
"Lateral geniculate",(Raphe AND (nuclei OR nucleus)),111,5069,8210,13279,0.00835906318247
("Centromedian" AND (nuclei OR nucleus)),Subthalam*,25,191,4104,4295,0.0058207217695
"Dorsolateral prefrontal",Parahippocamp*,107,2897,2552,5449,0.0196366305744
"Diagonal band of Broca",(Raphe AND (nuclei OR nucleus)),81,814,8240,9054,0.00894632206759
(Dorsomedial AND hypothal*),"Primary motor",0,2139,3205,5344,0.0
(Dorsomedial AND hypothal*),("Superior olive" OR "superior olivary"),13,2126,1244,3370,0.00385756676558
"Dorsolateral prefrontal",(Inferior AND collicul*),5,2999,4278,7277,0.000687096330906
(Cochlear AND (nuclei OR nucleus)),("Ventral anterior" AND (nuclei OR nucleus)),0,5307,237,5544,0.0
"Dentate gyrus",Entorhinal,1271,10172,4276,14448,0.0879706533776
(Dorsomedial AND hypothal*),"Ventral tegmentum",8,2131,277,2408,0.00332225913621
"Basal forbrain","Supplementary motor",0,1,2361,2362,0.0
Entorhinal,(Inferior AND collicul*),36,5511,4247,9758,0.00368928059028
"Calcarine fissure","Ventromedial prefrontal",0,103,3,106,0.0
("Heschl's gyrus" OR "Transverse temporal"),Thalamus,26,1122,42856,43978,0.000591204693256
Caudate,Orbitofrontal,231,18570,2765,21335,0.0108272791188
Cingulum,"Ventromedial prefrontal",0,685,3,688,0.0
("Heschl's gyrus" OR "Transverse temporal"),Perirhinal,8,1140,1192,2332,0.00343053173242
Cingulate,Temporoparietal,118,10986,1342,12328,0.00957170668397
Claustrum,("Straight gyrus" OR "gyrus rectus"),14,82727,116,82843,0.000168994362831
Fusiform,Temporoparietal,26,5429,1434,6863,0.00378843071543
"Inferior parietal lobule",("Ventral posteromedial" AND (nuclei OR nucleus)),1,795,111,906,0.00110375275938
"Inferior parietal lobule","Zona incerta",2,794,972,1766,0.00113250283126
("Medial dorsal" AND nucl*),("Posterior nucleus" AND hypothalamus),0,113,67,180,0.0
"Nucleus basalis",Thalamus,148,1699,42734,44433,0.00333085769586
periaqueductal,("Ventral posterolateral" AND (nuclei OR nucleus)),3,4573,145,4718,0.000635862653667
"Postcentral gyrus","Primary motor",25,506,3180,3686,0.00678241996744
Insula*,Pineal,16,17157,14387,31544,0.000507227998986
"Olfactory bulb","Zona incerta",46,11165,928,12093,0.00380385346895
"Postcentral gyrus","Superior frontal",40,491,1051,1542,0.0259403372244
Operculum,("Ventral posterior" AND (nuclei OR nucleus)),0,926,356,1282,0.0
"Olfactory bulb","Thalamic reticular",10,11201,590,11791,0.000848104486473
("Posterior nucleus" AND hypothalamus),Precuneus,0,67,1220,1287,0.0
"Primary sensory",Subiculum,86,2924,98155,101079,0.000850819655913
(Periventricular AND (nuclei OR nucleus)),Prefrontal,26,2469,24075,26544,0.000979505726341
Premotor,"Ventromedial prefrontal",0,4729,3,4732,0.0
"Middle frontal",Premotor,53,975,4676,5651,0.00937887099628
"Middle temporal","Superior temporal",470,1167,3637,4804,0.0978351373855
Perirhinal,Suprachiasmatic,9,1191,6017,7208,0.00124861265261
Pineal,Temporoparietal,1,14402,1459,15861,6.30477271294e-05
Striatum,Subgranular,20,58920,612,59532,0.000335953772761
"Piriform cortex","Supplementary motor",2,1741,2359,4100,0.000487804878049
"Primary sensory","Substantia nigra",20,2990,19367,22357,0.000894574406226
Precuneus,"Substantia nigra",7,1213,19380,20593,0.000339921332492
"Posterior parietal","Superior frontal",33,2121,1058,3179,0.0103806228374
"Superior temporal",("Superior olive" OR "superior olivary"),2,4105,1255,5360,0.000373134328358
Prefrontal,"Primary auditory",53,24048,1816,25864,0.00204918032787
(Raphe AND (nuclei OR nucleus)),"Ventromedial prefrontal",0,8321,3,8324,0.0
("Centromedian" AND (nuclei OR nucleus)),Cingulum,0,216,685,901,0.0
Putamen,"Zona incerta",79,10670,895,11565,0.00683095546909